あいかわおさむさんきち	相川治三吉	人名
あいたつじ	愛達治	人名
あいばとくさぶろう	相羽徳三郎	人名
あおききよし	青木清	人名
あおきしょう	青木翔	人名
あおきはじめ	青木一	人名
あおきまさゆき	青木正之	人名
あおちしろううえもん	青地四郎右衛門	人名
あおのいさお	青野功	人名
あおのてるいち	青野照市	人名
あおやぎとしお	青柳敏郎	人名
あかいけよしきち	赤池嘉吉	人名
あかいし	赤井氏	人名
あかいめぐみ	赤井芽久美	人名
あかおみのる	赤尾穣	人名
あかぎもんぞう	赤木文造	人名
あかぐみ	紅組	人名
あかはたたく	赤畠卓	人名
あかばれいこ	赤羽玲子	人名
あきたごろうはち	秋田五郎八	人名
あきづきけんたろう	秋月健太郎	人名
あきもとたかひろ	秋元崇宏	人名
あきもとようこ	秋本洋子	人名
あきやまうんあさ	秋山運朝	人名
あきやまかつらし	秋山桂史	人名
あきやまじゅんのぞみ	秋山純希	人名
あきやまたろう	秋山太郎	人名
あきやまひろし	秋山博	人名
あくつちから	阿久津主税	人名
あさいひろしうえもん	浅井宇右衛門	人名
あさくらしんご	浅倉真吾	人名
あさだひろふみ	浅田拓史	人名
あさぬまはじめ	浅沼一	人名
あさのしようへい	浅野翔平	人名
あさのたかや	浅野貴哉	人名
あさのだいすけ	浅野大輔	人名
あしがきかおる	芦垣薫	人名
あじきふさこ	安食総子	人名
あじままさとし	安嶋正敏	人名
あずまかずお	東和男	人名
あずまてるあき	東輝明	人名
あだちちあき	安達千明	人名
あだちりゅうた	安達竜太	人名
あだちりゅうた	安達龍太	人名
あつみまさゆき	渥美雅之	人名
あとむらみつお	後村光男	人名
あぶこうき	阿武晃樹	人名
あべあきひろ	阿部晃大	人名
あべきょうぞう	阿部恭三	人名
あべけんじろう	阿部健治郎	人名
あべこうる	阿部光瑠	人名
あべさゆり	阿部小百合	人名
あべしんいちろう	阿部信一郎	人名
あべたかし	阿部充	人名
あべたかし	阿部隆	人名
あべたろう	阿部太郎	人名
あまのあきら	天野昭	人名
あまのけいご	天野啓吾	人名
あまのさとし	天野聡	人名
あまのさとし	天野聰	人名
あまのそうほ	天野宗歩	人名
あまのたかし	天野高志	人名
あまのよしもと	天野貴元	人名
あらいたつひと	荒井辰仁	人名
あらいだもとのぶ	新井田基信	人名
あらきせんとうと	荒木宣貴	人名
あらきひでお	荒木秀雄	人名
あらまきみつゆき	荒巻三之	人名
ありうらしるしり	有浦印理	人名
ありかわだいすけ	有川大輔	人名
ありぎかおる	在木馨	人名
ありのよしと	有野芳人	人名
ありまえもん	有馬衛門	人名
ありまへいない	有馬平内	人名
ありもとへいない	有本平内	人名
ありもりこうぞう	有森浩三	人名
ありよしみちお	有吉道夫	人名
あわじひとしげ	淡路仁茂	人名
あんざいしょういち	安西勝一	人名
あんどうまさひろ	安藤昌弘	人名
あんぺいじえいいちろう	安平次英一郎	人名
あんようじたかのり	安用寺孝功	人名
いいかわたよんろう	飯河他四郎	人名
いいざわかんざぶろう	飯澤勘三郎	人名
いいざわしげゆき	飯澤重行	人名
いいじまあつや	飯島篤也	人名
いいじまえいじ	飯島栄治	人名
いいじままなぶ	飯嶋学	人名
いいだてつお	飯田哲生	人名
いいだひろゆき	飯田弘之	人名
いいづかかんいちろう	飯塚勘一郎	人名
いいづかそういち	飯塚総一	人名
いいづかひろき	飯塚祐紀	人名
いいづかりょうま	飯塚龍馬	人名
いいのあい	飯野愛	人名
いいのけんじ	飯野健二	人名
いかいひでじ	伊貝秀司	人名
いがらしいちじゅうろう	五十嵐市十郎	人名
いがらしとよいち	五十嵐豊一	人名
いがりたかお	猪狩孝夫	人名
いくしまえいぞう	生島栄蔵	人名
いくじまひこさぶろう	幾嶋彦三郎	人名
いぐちまさたか	井口真孝	人名
いけあつし	池篤志	人名
いけじまじゅん	池島純	人名
いけだあつし	池田篤史	人名
いけだえいじ	池田英司	人名
いけだかずこ	池田和子	人名
いけだきくおんな	池田菊女	人名
いけだしちへいまもる	池田七平衛	人名
いけだしゅういち	池田修一	人名
いけだしんたろう	池田信太郎	人名
いけだすすむ	池田将	人名
いけだたけし	池田猛	人名
いけだだいすけ	池田大助	人名
いけだまさとよ	池田正仁	人名
いけだまさゆき	池田将之	人名
いけだまさゆき	池田昌幸	人名
いけだまつのすけ	池田松之助	人名
いけだむつみ	池田睦美	人名
いけだよういち	池田陽一	人名
いけながてんし	池永天志	人名
いけふじけんすけ	生藤健介	人名
いこまにざえもん	生駒仁左衛門	人名
いこまひこさぶろう	生駒彦三郎	人名
いこまよへえ	生駒与兵衛	人名
いざわさき	井沢早紀	人名
いしいけんたろう	石井健太郎	人名
いしいなおき	石井直樹	人名
いしいひでよし	石井秀吉	人名
いしいゆたか	石井豊	人名
いしうちななえ	石内奈々絵	人名
いしかわあきお	石川陽生	人名
いしかわかつしろう	石川勝四郎	人名
いしかわしろう	石川四郎	人名
いしかわたけし	石川孟司	人名
いしかわやすし	石川泰	人名
いしかわゆうじろう	石川友次郎	人名
いしかわゆうた	石川優太	人名
いしかわよしお	石川由男	人名
いしがきあつし	石垣毅	人名
いしがきじゅんじ	石垣純二	人名
いしがきながたけ	石垣長武	人名
いしがやし	石谷氏	人名
いしざかしんさく	石坂慎作	人名
いしざかひろあき	石坂浩明	人名
いしたかすみえ	石高澄恵	人名
いしだうたろく	石田哥六	人名
いしだかずあき	石田和明	人名
いしだかずお	石田和雄	人名
いしだけいじ	石田桂司	人名
いしだけんぎょう	石田検校	人名
いしだしげるよし	石田秀芳	人名
いしだなおひろ	石田直裕	人名
いしだひろし	石田宏	人名
いしづかとおる	石塚徹	人名
いしとびえいじ	石飛英二	人名
いしどうただし	石堂正	人名
いしはらけんじ	石原健次	人名
いしはらすえきち	石原末吉	人名
いしはらたかひさ	石原敬久	人名
いしはらたけみぎ	石原丈右	人名
いしはらとしお	石原利男	人名
いしはらまさる	石原勝	人名
いしはらゆうきち	石原勇吉	人名
いしばしかおる	石橋薫	人名
いしばしけいたろう	石橋敬太郎	人名
いしばしさちお	石橋幸緒	人名
いしばしやすひろ	石橋安広	人名
いしぼりこうじ	石堀浩二	人名
いしもとけんぎょう	石本検校	人名
いしもとゆう	石本優	人名
いしやまえいいちろう	石山永一郎	人名
いしわたまさお	石渡政夫	人名
いずみきよし	泉清志	人名
いずみちしゅうしん	泉地修身	人名
いずみのあきら	泉野晃	人名
いずみまさき	泉正樹	人名
いずみやぜんべえ	和泉屋善兵衛	人名
いそべりんぞう	磯辺林蔵	人名
いたばしさだお	板橋貞夫	人名
いたばしひとし	板橋等	人名
いたやしろう	板谷四郎	人名
いたやすすむ	板谷進	人名
いだちょうさえもん	井田長左衛門	人名
いちかわいちろう	市川一郎	人名
いちかわきよし	市川清	人名
いちかわさとしさぶろう	市川覚三郎	人名
いちかわしゃちゅう	市川車中	人名
いちかわしん	市川伸	人名
いちかわたろうまつ	市川太郎松	人名
いちかわとしお	市川利雄	人名
いちかわとしお	市川敏夫	人名
いちかわとしゆき	市川敏之	人名
いちかわらんゆき	市川蘭雪	人名
いちのせこうじ	一瀬浩司	人名
いちのせせいはち	一ノ瀬清八	人名
いちのせだん	市瀬弾	人名
いちはしやすたか	市橋康孝	人名
いちはらこうじ	市原康司	人名
いっしきあつし	一色厚志	人名
いでちから	井出主税	人名
いとうあすか	伊藤明日香	人名
いとういんたつ	伊藤印達	人名
いとうかずお	伊藤和夫	人名
いとうかずゆき	伊藤和幸	人名
いとうかんじゅ	伊藤看寿	人名
いとうきへえ	伊藤喜兵衛	人名
いとうきょうし	伊藤享史	人名
いとうきんごろう	伊藤金五郎	人名
いとうけいた	伊藤啓太	人名
いとうさえ	伊藤沙恵	人名
いとうさだひで	伊藤禎英	人名
いとうさやか	伊藤さやか	人名
いとうしげる	伊藤茂	人名
いとうしゅんたけ	伊藤俊丈	人名
いとうしるしよしみ	伊藤印嘉	人名
いとうしんご	伊藤真吾	人名
いとうすすむ	伊藤進	人名
いとうそういん	伊藤宗印	人名
いとうたいご	伊藤大悟	人名
いとうたかとし	伊藤貴敏	人名
いとうだいご	伊藤大吾	人名
いとうだいすけ	伊藤大介	人名
いとうとうきち	伊藤東吉	人名
いとうのう	伊藤能	人名
いとうはたす	伊藤果	人名
いとうひさしさん	伊藤寿三	人名
いとうひろぶみ	伊藤博文	人名
いとうまさあき	伊藤雅明	人名
いとうまんぺい	伊藤萬平	人名
いとうみさ	伊藤看佐	人名
いとうみじょ	伊藤看恕	人名
いとうみずほ	伊藤瑞穂	人名
いとうみり	伊藤看理	人名
いとうやすのり	伊藤康了	人名
いとうやすはる	伊藤康晴	人名
いとうやすはる	伊藤靖治	人名
いとうやすひろ	伊藤靖浩	人名
いとうゆきこ	伊藤友紀子	人名
いとだにてつろう	糸谷哲郎	人名
いどうちひろ	井道千尋	人名
いどひろし	井土宏	人名
いながわまなか	伊奈川愛菓	人名
いなつしゅうすけ	稲津宗助	人名
いなづきけんいち	稲月健一	人名
いなばあきら	稲葉陽	人名
いなばいへえ	因幡伊兵衛	人名
いなばさとし	稲葉聡	人名
いなばしょうじろう	稲葉昭二郎	人名
いなむらけいすけ	稲村桂助	人名
いなゆうすけ	伊奈祐介	人名
いなゆうすけ	伊奈裕介	人名
いぬいとしお	乾俊雄	人名
いぬいわたる	乾渉	人名
いぬぶせしょうざぶろう	犬伏正三郎	人名
いぬぶせてつじ	犬伏徹志	人名
いねやましょううえもん	稲山庄右衛門	人名
いのうえきよし	井上潔	人名
いのうえくまじろう	井上熊次郎	人名
いのうえけいいち	井上慧一	人名
いのうえけいた	井上慶太	人名
いのうえてつや	井上徹也	人名
いのうえてるひこ	井上輝彦	人名
いのうえにえもん	井上仁右衛門	人名
いのうえにざえもん	井上仁左衛門	人名
いのうえひろし	井上宏	人名
いのうえまさひろ	井上雅裕	人名
いのうえよしお	井上義雄	人名
いのまたけんぶん	猪股賢文	人名
いぼりしゅうさく	井堀周作	人名
いまいあや	今井絢	人名
いまいすすむ	今井進	人名
いまいずみけんじ	今泉健司	人名
いまいれいこれ	今井玲之	人名
いまにしかずひと	今西一仁	人名
いまにしけんじ	今西健二	人名
いまむらたかし	今村充	人名
いまんじょうようすけ	今城洋亮	人名
いむらへいじろう	井村兵次郎	人名
いむらへいはる	井村兵春	人名
いむられいじ	井村励児	人名
いもとりんたろう	井元林太郎	人名
いりふねこうみ	入船工味	人名
いりやまりょうへい	入山稜平	人名
いれこなおき	入子直樹	人名
いわいずみあつし	岩泉毅	人名
いわさきごろうひょうえ	岩崎五郎兵衛	人名
いわさわおくと	岩沢億斗	人名
いわせおとじろう	岩瀬音次郎	人名
いわたしげお	岩田成雄	人名
いわたとしゆき	岩田智之	人名
いわたによしお	岩谷良雄	人名
いわたゆうすけ	岩田裕介	人名
いわでいちえもん	岩出市右衛門	人名
いわねしのぶ	岩根忍	人名
いわまむねや	岩間宗八	人名
いわむらけんぎょう	岩村検校	人名
いわもとしようごろう	岩本正五郎	人名
うえきしんや	植木慎也	人名
うえきつとむ	植木力	人名
うえだあいかつら	上田愛桂	人名
うえださんぞう	上田三三	人名
うえだしょうへい	上田庄平	人名
うえだじゅんいち	上田純一	人名
うえだてつし	上田哲士	人名
うえだはつみ	上田初美	人名
うえだひろし	上田洋	人名
うえだみのる	上田実	人名
うえちりゅうぞう	上地隆蔵	人名
うえのいさぶろう	上野伊三郎	人名
うえのひろかず	上野裕和	人名
うえのひろし	植野博	人名
うえのみつひろ	植野光博	人名
うえのゆういち	上野祐一	人名
うえむらまり	植村真理	人名
うえやまよしゆき	植山悦行	人名
うおのやさぶろう	魚野弥三郎	人名
うかいやごろう	鵜飼弥五郎	人名
うさみやすゆき	宇佐美安行	人名
うしおやすゆき	潮靖之	人名
うしおりゅうじ	潮隆次	人名
うじまさこ	宇治正子	人名
うちだげんかち	内田玄勝	人名
うちだしょうきち	内田昭吉	人名
うちだじゅうべえ	内田十兵衛	人名
うつのみややすひこ	宇都宮靖彦	人名
うねみよきち	畝美与吉	人名
うのきまなぶ	鵜木学	人名
うぶかたひさし	生方寿	人名
うめあさひちんきくおんな	梅旭亭菊女	人名
うめきのきむねとつ	梅樹軒宗凸	人名
うめたにかんち	梅谷観治	人名
うめはらりゅうざぶろう	梅原龍三郎	人名
うらたきんじろう	浦田金次郎	人名
うらたきんじろう	浦田金治郎	人名
うらののぶひろ	浦野亘弘	人名
うらのまさひこ	浦野真彦	人名
うわふじみつじろう	上藤三次郎	人名
えいせいさぶろう	英清三郎	人名
えざきひさお	江崎久夫	人名
えちぜんえいたつ	越前永達	人名
えのもとこうぞう	榎本幸造	人名
えはたますみ	江畑真澄	人名
えびはらたつお	海老原辰夫	人名
えんだじゅんいち	遠田潤一	人名
えんどうつばさ	遠藤翼	人名
えんどうときお	遠藤登喜男	人名
えんどうまこと	遠藤誠	人名
えんどうまさき	遠藤正樹	人名
えんどうやたろう	遠藤彌太郎	人名
おいかわたくま	及川拓馬	人名
おおいさとし	大井悟史	人名
おおいしただし	大石直嗣	人名
おおいなかつかさしょうほ	大井中務少輔	人名
おおうちけんすけ	大内健介	人名
おおうちのぶゆき	大内延介	人名
おおうちもえ	大内萌	人名
おおうらいわお	大浦厳	人名
おおおかひょうぶしょうほ	大岡兵部少輔	人名
おおがきひろあき	大垣宏明	人名
おおがみしまよし	大神島吉	人名
おおきかずひろ	大木和博	人名
おおきさかえのき	大木榮軒	人名
おおくぼけんご	大久保研吾	人名
おおくぼひろお	大久保裕雄	人名
おおくぼまさる	大久保勝	人名
おおこしまこと	大越誠	人名
おおさかやふとしひょうえ	大阪屋太兵衛	人名
おおさきくまお	大崎熊雄	人名
おおさわきんぞう	大澤金蔵	人名
おおしたとしこう	大下慧香	人名
おおしまえいじ	大島映二	人名
おおしまきへえ	大島喜兵衛	人名
おおしろやすひろ	大城康浩	人名
おおすぎぎいち	大杉義一	人名
おおすぎゆう	大杉悠	人名
おおたかずひろ	大多和裕	人名
おおたしんいちろう	太田振一郎	人名
おおたしんとき	太田震斎	人名
おおただんうえもん	太田弾右衛門	人名
おおたひろお	太田博朗	人名
おおたまなぶ	大田学	人名
おおたまなぶ	太田學	人名
おおたもとうえもん	太田元右衛門	人名
おおつかげんえもん	大塚源右衛門	人名
おおつかじんきちうえもん	大塚甚右衛門	人名
おおつきたかし	大槻敬	人名
おおつごろうざえもん	大津五郎左衛門	人名
おおともかんじ	大友寛二	人名
おおとものぼる	大友昇	人名
おおにしかずひろ	大西一広	人名
おおにしきさぶろう	大西喜三郎	人名
おおにしなりあき	大西就明	人名
おおにしひかり	大西光	人名
おおぬまひろゆき	大沼洋之	人名
おおのげんいち	大野源一	人名
おおのせいじ	大野清司	人名
おおのひろき	大野弘喜	人名
おおのやいちお	大野八一雄	人名
おおはしきょせん	大橋巨泉	人名
おおはしたかひろ	大橋貴洸	人名
おおはしなみおんな	大橋浪女	人名
おおはしやながわ	大橋柳川	人名
おおはしやなぎゆき	大橋柳雪	人名
おおはらえいじ	大原英二	人名
おおばたけし	大場武志	人名
おおばまさゆき	大場正幸	人名
おおばみか	大庭美夏	人名
おおばみき	大庭美樹	人名
おおひらたけひろ	大平武洋	人名
おおひらやすひろ	大平泰弘	人名
おおまえよしあき	大前吉章	人名
おおみねひろゆき	大峰裕之	人名
おおむらかずひさ	大村和久	人名
おおむらただお	大村忠雄	人名
おおやとうきち	大矢東吉	人名
おおやまやすはる	大山康晴	人名
おおわくたけし	大和久彪	人名
おかざきしめい	岡崎史明	人名
おかざきひろし	岡崎洋	人名
おかだかずき	岡田和樹	人名
おかだかつひろ	岡田勝浩	人名
おかださない	岡田左内	人名
おかだしょうご	岡田昇吾	人名
おかだゆうすけ	岡田裕介	人名
おかのいずみもり	岡野和泉守	人名
おかのこう	岡野公	人名
おかばたあきらはん	岡畑明範	人名
おかむらいくじろう	岡村幾次郎	人名
おかむらほうたろう	岡村豊太郎	人名
おかむらまさふみ	岡村正文	人名
おかもいつき	岡茂樹	人名
おかもととしひろ	岡本敏弘	人名
おかもとようすけ	岡本洋介	人名
おかやすれいじ	岡安玲士	人名
おかわだたけし	岡和田剛	人名
おがさわらいちろう	小笠原一郎	人名
おがさわらかすみ	小笠原香純	人名
おがたたかし	尾形充	人名
おがわえいじ	小川英二	人名
おがわこういち	小川浩一	人名
おがわさとし	小川聡	人名
おがわしおり	小川詩織	人名
おがわしゅうと	緒川集人	人名
おがわなおずみ	小河直純	人名
おきざきけんじ	沖崎憲治	人名
おきもとじ	沖元二	人名
おきりゅうさく	沖竜作	人名
おぎたしげじろう	荻田重次郎	人名
おくさかきんじろう	奥坂金治郎	人名
おくだひだりへいじ	奥田左平治	人名
おくだひろし	奥田寛	人名
おくだみやこ	奥田京	人名
おくだりえ	奥田理恵	人名
おくのいつか	奥野一香	人名
おくのしん	奥野真	人名
おくのはじめよし	奥野基芳	人名
おくはらただよし	奥原忠吉	人名
おくむらあきら	奥村明	人名
おくむらともろう	奥村友朗	人名
おくむらゆきまさ	奥村幸正	人名
おくむらよしお	奥村佳生	人名
おくむらりょうま	奥村龍馬	人名
おくもとこころ	奥本心	人名
おくやまひろし	奥山浩士	人名
おぐらひさし	小倉久史	人名
おぐりよしたか	小栗義孝	人名
おけやいくお	桶屋郁夫	人名
おざきさやか	尾崎さやか	人名
おざさきちじろう	小笹吉次郎	人名
おざわあざび	小澤あざ美	人名
おざわしんご	小澤真吾	人名
おざわたけしまつ	小沢武末	人名
おぜきけんた	小関健太	人名
おだいさぶろう	小田伊三郎	人名
おださくのすけ	織田作之助	人名
おだとしょ	織田図書	人名
おちあいよしみつ	落合好光	人名
おちゅうかずよし	尾中一喜	人名
おのあつお	小野敦生	人名
おのけんぞう	小野憲三	人名
おのごへい	小野五平	人名
おのしゅういち	小野修一	人名
おのそうじろう	小野惣次郎	人名
おのひづる	小野比鶴	人名
おのへいさえもん	小野兵左衛門	人名
おのゆかり	小野ゆかり	人名
おばたきくじろう	小畑菊次郎	人名
おばたしゅんぶん	小幡春分	人名
おもとけいいち	尾本恵市	人名
おもねだれと	阿誰都	人名
おりたしょうご	折田翔吾	人名
かいともみ	甲斐智美	人名
かいのきなおざぶろう	栢木直三郎	人名
かいはらこうじ	開原孝治	人名
かいひなた	甲斐日向	人名
かおれだけおとこ	川上岳男	人名
かかわさひょうえ	加川佐兵衛	人名
かがたかはる	加賀敬治	人名
かがやひろみ	加賀屋浩美	人名
かがわえいまつ	香川栄松	人名
かがわまなお	香川愛生	人名
かきぬましょうじ	柿沼昭治	人名
かぎやしょうべえ	鍵屋庄兵衛	人名
かくたみつお	角田三男	人名
かくひろしよう	加來博洋	人名
かくひろしよう	加来博洋	人名
かさいゆき	笠井友貴	人名
かさぎのぶや	笠木伸哉	人名
かしまひろし	鹿島寛	人名
かしまりえもん	鹿島利右衛門	人名
かしゅうしょうぞう	賀集正三	人名
かしわぐらすえまつ	柏倉末松	人名
かじいちろう	梶一郎	人名
かじたにおさむ	梶谷修	人名
かじはらたつなり	梶原達成	人名
かじよしのぶ	加地嘉信	人名
かずさゆうじろう	上総雄二郎	人名
かせさとし	加瀬恵司	人名
かせじゅんいち	加瀬純一	人名
かせまつお	嘉瀬松雄	人名
かたおかりな	片岡理奈	人名
かたがみだいすけ	片上大輔	人名
かたやまあきら	片山晃	人名
かたやまりょうぞう	片山良三	人名
かっせきとしひさ	葛石利久	人名
かつうらおさむ	勝浦修	人名
かつうらまつのすけ	勝浦松之助	人名
かつうらりえもん	勝浦利右衛門	人名
かつたかんべえ	勝田勘兵衛	人名
かつまたきよかず	勝又清和	人名
かつまたたまき	勝又環	人名
かつやましょうじろう	勝山庄次郎	人名
かつやまじろう	勝山治郎	人名
かつらやまたくお	葛山拓生	人名
かとうけいぞう	加藤恵三	人名
かとうけいぞう	加藤桂三	人名
かとうげんば	加藤玄蕃	人名
かとうしんご	加藤信吾	人名
かとうじろう	加藤治郎	人名
かとうすすむ	加藤進	人名
かとうすみか	加藤寿美香	人名
かとうたけじろう	加藤竹次郎	人名
かとうとおる	加藤徹	人名
かとうともや	加藤智也	人名
かとうとらのすけ	加藤寅之助	人名
かとうひかりしげる	加藤光成	人名
かとうひふみ	加藤一二三	人名
かとうひろじ	加藤博二	人名
かとうふく	加藤富久	人名
かとうふみあき	加藤文章	人名
かとうみい	加藤看意	人名
かとうももこ	加藤桃子	人名
かとうゆうご	加藤悠吾	人名
かとうゆきお	加藤幸男	人名
かとうゆきすけ	加藤幸助	人名
かとうよしぞう	加藤嘉三	人名
かとうよしつぐ	加藤慶次	人名
かどくらけいた	門倉啓太	人名
かどやよしかず	門屋良和	人名
かないこうた	金井恒太	人名
かないたかし	金井貴司	人名
かなうちたつあき	金内辰明	人名
かなざわけんいち	金澤健一	人名
かなもりよしみ	金盛吉美	人名
かねおやばんち	金親盤治	人名
かねこきんごろう	金子金五郎	人名
かねこしゅん	金子俊	人名
かねこたかし	金子タカシ	人名
かねこたへい	金子太平	人名
かねこのりよしいっ	金子紀良逸	人名
かねこまこと	金子誠	人名
かねこまさてる	金子正輝	人名
かねこやすひろ	金子泰大	人名
かねこよしあき	金子義昭	人名
かねこよしゆき	金子義之	人名
かねざわたかし	金沢孝史	人名
かねたかせいきち	金高清吉	人名
かねつきかつすけ	金築克祐	人名
かねなわしんざえもん	金縄新左衛門	人名
かねまきとものり	印牧知徳	人名
かのたまお	鹿野圭生	人名
かのまさし	狩野真志	人名
かのみつる	嘉野満	人名
かべやすはる	加部康晴	人名
かまたひでのり	鎌田英典	人名
かみかわいちぼし	神川一星	人名
かみしょうのすけ	神庄之助	人名
かみじょうさち	上條祥	人名
かみたんごまもる	神丹後守	人名
かみひょうごあたま	神兵庫頭	人名
かみまえみつぞう	神前光三	人名
かみむらわたる	上村亘	人名
かみやたかし	神谷崇	人名
かみやひろし	神谷広志	人名
かめおかなおみ	亀岡奈保美	人名
かめたにげんご	亀谷源吾	人名
かめたにつとむ	狼谷力	人名
かやたにひろしろう	萱谷裕司郎	人名
かやままさあき	加山雅昭	人名
からさわりえこ	唐澤利恵子	人名
かりがねせいきち	雁金清吉	人名
かるべりゅうたろう	軽部龍太郎	人名
かわいさとし	河井智	人名
かわいひとし	河合仁	人名
かわいふさくに	川井房郷	人名
かわいやすし	川合仁	人名
かわうちあつし	川内篤	人名
かわかみげんぞう	川上源蔵	人名
かわかみたけし	川上猛	人名
かわかみちょうじろう	川上長次郎	人名
かわぐちとおる	川口徹	人名
かわぐちとしひこ	河口俊彦	人名
かわさきそら	河崎素良	人名
かわさきやそはち	川崎八十八	人名
かわさきゆうじ	川崎裕史	人名
かわしまそうのぞみ	河島宗臨	人名
かわずみまさのり	川角昌徳	人名
かわそえさくべえ	川副作兵衛	人名
かわぞえまつごろう	川添松五郎	人名
かわたてつろう	川田哲郎	人名
かわのひろゆき	河野宏之	人名
かわはらけい	河原慶	人名
かわはらやすし	河原靖	人名
かわぶちせいれい	川縁征令	人名
かわむらしげお	河村茂雄	人名
かわむらだいきち	川村大吉	人名
かわむらゆうじん	川村悠人	人名
かわもとおさむ	川本修	人名
かわらばやしたかひこ	河原林隆彦	人名
かわらばやしひでのり	河原林秀典	人名
かんきひろみつ	神吉宏充	人名
かんざきけんじ	神崎健二	人名
かんたごもりたすく	菅田龍佐	人名
かんださんよう	神田山陽	人名
かんだしずお	神田鎮雄	人名
かんだたつのすけ	神田辰之助	人名
かんだまゆみ	神田真由美	人名
かんのさき	菅野早紀	人名
かんのしげる	菅野茂	人名
かんのりんたろう	菅野倫太郎	人名
かんひろふみ	康祐文	人名
かんべただひろ	神辺忠宏	人名
かんべともまさ	神戸智大	人名
きがわきいち	木川貴一	人名
きくかわひろゆき	菊川裕之	人名
きくたきみあつし	菊田公毅	人名
きくたゆうじ	菊田裕司	人名
きくちかん	菊池寛	人名
きくちたかし	菊池隆	人名
きくちつねお	菊地常夫	人名
きくちゆうた	菊地裕太	人名
きくよしあき	木久敬章	人名
きぐちしょうたろう	木口翔太郎	人名
きざわとらきち	木澤寅吉	人名
きたおかぜんすけ	北岡善助	人名
きたおまどか	北尾まどか	人名
きたがわいやへいじ	北川彌平次	人名
きたがわかおる	北川馨	人名
きたがわなおや	北川直哉	人名
きたぐちかなめ	北口要	人名
きたざわかおり	北澤香織	人名
きたじまくにひろ	北島邦裕	人名
きたじまただお	北島忠雄	人名
きただてしゅうや	北楯修哉	人名
きたのさちひこ	北野幸彦	人名
きたのたかしひろし	北野敬寛	人名
きたはまけんすけ	北浜健介	人名
きたばたけさとる	北畠悟	人名
きたむらけいか	北村桂香	人名
きたむらこういち	北村公一	人名
きたむらしゅん	北村俊	人名
きたむらなおゆき	北村直之	人名
きたむらなにもとむ	北村何求	人名
きたむらひでじろう	北村秀治郎	人名
きたむらふみお	北村文男	人名
きたむらまさお	北村昌男	人名
きたやまかずお	北山和夫	人名
きたやまかずすけ	北山和佑	人名
きたやまかんじろう	北山官次郎	人名
きたわきせいや	北脇誠也	人名
きったくに	橘田公仁	人名
きどまさたか	木戸政隆	人名
きのしたあきら	木下晃	人名
きのしたげんたろう	木下源太郎	人名
きのしたこういち	木下浩一	人名
きのしたこうたろう	木下孝太郎	人名
きのしたしかじろう	木下鹿次郎	人名
きのしたゆういち	木下勇一	人名
きはらかずまろ	木原和麿	人名
きみきんじろう	木見金治郎	人名
きみじましゅんすけ	君島俊介	人名
きみのと	君の都	人名
きむらあつのり	木村篤典	人名
きむらかずき	木村一基	人名
きむらきゅうよねすけ	木村久米助	人名
きむらけいさく	木村恵作	人名
きむらしんぢ	木村慎治	人名
きむらひでとし	木村秀利	人名
きむらみのる	木村実	人名
きむらよしお	木村義雄	人名
きむらよしたか	木村嘉孝	人名
きむらよしのり	木村義徳	人名
きやたいじ	木屋太二	人名
きゅうだいおおはしたかしあずか	九代大橋宗与	人名
きょうすゆきお	京須行男	人名
きよやまとくじ	清山徳司	人名
きりたにひろと	桐谷広人	人名
きりはたちゅうべえ	霧畑忠兵衛	人名
きりやまきよすみ	桐山清澄	人名
きりやまたかし	桐山隆	人名
くぎざきただし	釘崎正	人名
くしだよういち	櫛田陽一	人名
くすのきまつゆき	楠松雪	人名
くすもとせいじ	楠本誠二	人名
くだいおおはしそうけい	九代大橋宗桂	人名
くどうかおり	工藤佳織	人名
くどうこうへい	工藤浩平	人名
くどうやすひこ	工藤康彦	人名
くにいほうりほまれ	国井祝誉	人名
くにこしはじめ	國越一	人名
くぼたかし	久保貴史	人名
くぼたよしゆき	窪田義行	人名
くぼとしあき	久保利明	人名
くぼはるお	久保晴生	人名
くぼもとてるお	久保本晃夫	人名
くまがいただつぐ	熊谷忠次	人名
くまがいただはる	熊谷忠治	人名
くまがいみちひと	熊谷達人	人名
くまがいみむら	熊谷三邨	人名
くまくらおのうえもん	熊倉小野右衛門	人名
くまくらむらさきの	熊倉紫野	人名
くまさかまなぶ	熊坂学	人名
くまだまさる	久万田勝	人名
くまのつよし	熊野剛	人名
くめかろく	久米可六	人名
くめてつじろう	久米鉄次郎	人名
くめひろし	久米宏	人名
くもみやひろゆき	雲宮宏之	人名
くらかわしょう	倉川尚	人名
くらしまたけじろう	倉島竹二郎	人名
くらはしだい	倉橋第	人名
くらもときのすけ	倉本喜之助	人名
くらもとたろう	蔵元太郎	人名
くらよしきん	倉吉金	人名
くりおぐんば	栗尾軍馬	人名
くりはらまさし	栗原昌志	人名
くりゅうなおき	栗生直樹	人名
くろかわたくみ	黒川内匠	人名
くろかわのりお	黒川紀夫	人名
くろかわりゅうたん	黒川龍潭	人名
くろさきしょういち	黒崎昌一	人名
くろさわだいきち	黒澤大吉	人名
くろさわれお	黒沢怜生	人名
くろだたかゆき	黒田尭之	人名
くわえひろしたけ	桑江裕丈	人名
くわえゆうだい	桑江裕大	人名
くわおこのめん	桑尾此面	人名
くわしましゅん	桑島俊	人名
くわしまどんあきらこ	桑島鈍聴子	人名
くわばらいちろう	桑原一郎	人名
くわばらくんなか	桑原君仲	人名
くわばらけいご	桑原圭吾	人名
くわばらはじめ	桑原始	人名
くわばらまさとも	桑原雅知	人名
くわやましょうじ	桑山尚司	人名
けいやすひろ	渓康広	人名
けづかげんすけ	毛塚源助	人名
けんもちしょうじ	剱持松二	人名
けんもちまつじ	劔持松二	人名
げきさし	激指	人名
こいいだよへい	小飯田與平	人名
こいけえいじ	小池英司	人名
こいけじゅうめい	小池重明	人名
こいけゆうき	小池裕樹	人名
こいずみありあけ	小泉有明	人名
こいずみけんきち	小泉兼吉	人名
こいずみたくや	小泉卓也	人名
こいずみひろみ	小泉祐美	人名
こいずみまさのぶ	小泉雅信	人名
こいずみゆう	小泉祐	人名
こいでげんきち	小出源吉	人名
こうざいたけお	香西健男	人名
こうじょうけい	向上啓	人名
こうじんもとみ	講神元美	人名
こうだ	香田	人名
こうだろはん	幸田露伴	人名
こうとくまさき	高徳昌毅	人名
こうどまこと	河戸誠	人名
こうのくすお	河野久寿雄	人名
こうのひでみ	河野日出美	人名
こうはしくにしん	高橋国伸	人名
こうむらたもつぶん	香村保文	人名
こうらきっと	小浦吉登	人名
こがいたるはん	古賀達範	人名
こがいちろう	古賀一郎	人名
こがゆうきよし	古賀悠聖	人名
こがわしんうえもん	小川新右衛門	人名
こぐちはじめ	古口基	人名
こぐれかつひろ	小暮克洋	人名
こぐれつねお	小暮恒男	人名
こぐれとくお	小暮得雄	人名
こさかのぼる	小阪昇	人名
こさかひでお	小坂英男	人名
こさくのぼる	古作登	人名
こざきひろつぐ	古崎宏二	人名
こしがやつよし	越谷剛	人名
こじまあきらさとる	小島明悟	人名
こじまおとうえもん	小島音右衛門	人名
こじまかずひろ	小島一宏	人名
こすげけんのすけ	小菅剣之助	人名
こたきいちべえ	小滝市兵衛	人名
こたきもとやす	小滝元靖	人名
こだまこういち	児玉孝一	人名
こだませいこ	児玉星湖	人名
こづつみいちぼし	小堤一星	人名
こでらあつひと	小寺淳人	人名
こにしたけし	小西武史	人名
このまひであき	木間秀晃	人名
こばやしあずましろう	小林東四郎	人名
こばやしいさおしゅん	小林庸俊	人名
こばやしいさむせき	小林勇碩	人名
こばやしきょうじ	小林恭二	人名
こばやしけいこ	小林恵子	人名
こばやしけんじ	小林健二	人名
こばやしこうざぶろう	小林孝三郎	人名
こばやしさだくすのき	小林定楠	人名
こばやしさとる	小林悟	人名
こばやししかじろう	小林鹿次郎	人名
こばやししんいち	小林伸市	人名
こばやしすみお	小林純夫	人名
こばやしたいち	小林太一	人名
こばやしともなお	小林知直	人名
こばやしはるほ	小林春穂	人名
こばやしひろし	小林宏	人名
こばやしひろし	小林裕士	人名
こばやしひろたく	小林広卓	人名
こばやしまさよし	小林正美	人名
こばやしやすたろう	小林康太郎	人名
こばやしよしゆきすけ	小林慶之助	人名
こぼりあきひろ	小堀晃弘	人名
こぼりあや	小堀綾	人名
こぼりせいいち	小堀清一	人名
こまきつよし	小牧毅	人名
こまつうしのすけ	小松牛之助	人名
こまつすみお	小松純夫	人名
こまつていきち	小松定吉	人名
こまつばらみちひろ	小松原道広	人名
こまつみか	小松三香	人名
こもりゆうた	古森悠太	人名
こもりゆきお	小森行雄	人名
こやこうすけ	古屋皓介	人名
こやまきない	小山喜内	人名
こやまゆうじろう	小山友次郎	人名
こやまれお	小山怜央	人名
これのりたかゆき	是則隆幸	人名
これやすまりこ	是安真理子	人名
こんたかし	昆隆志	人名
こんどうあきひさ	金堂晃久	人名
こんどうけいいち	近藤桂一	人名
こんどうせいや	近藤誠也	人名
こんどうたかし	近藤孝	人名
こんどうひでよ	今藤英世	人名
こんどうまさかず	近藤正和	人名
こんどうみちよし	近藤道義	人名
こんやすじろう	金易二郎	人名
ごいよしあき	五井嘉明	人名
ごうぎしすてむ	合議システム	人名
ごうだまさたか	郷田真隆	人名
ごだいいとうそういん	五代伊藤宗印	人名
ごだいおおはしそうけい	五代大橋宗桂	人名
ごだいおおはしむねより	五代大橋宗順	人名
ごとうさとる	後藤聡	人名
ごとうはじめ	後藤基	人名
ごとうよういち	後藤洋市	人名
ごんどうとしお	権藤敏夫	人名
さいだじゅんいち	斎田純一	人名
さいだだいゆう	才田大祐	人名
さいだのぶゆき	才田信之	人名
さいだはるこ	斎田晴子	人名
さいとうあきら	斉藤輝	人名
さいとうかずひろ	斉藤一弘	人名
さいとうぎんじろう	斎藤銀次郎	人名
さいとうけいざぶろう	斎藤敬三郎	人名
さいとうけいじろう	斎藤啓二郎	人名
さいとうしげゆき	斉藤繁之	人名
さいとうしんたろう	斎藤慎太郎	人名
さいとうたかおみ	斎藤貴臣	人名
さいとうちょうさぶろう	斎藤長三郎	人名
さいとうつとむ	斉藤努	人名
さいとうつとむ	斎藤努	人名
さいとうつよし	斉藤剛	人名
さいとうつよし	斉藤豪士	人名
さいとうつよし	斎藤剛	人名
さいとうとういん	齋藤藤蔭	人名
さいとうへいはち	斎藤平八	人名
さいとうまこと	斎藤誠	人名
さいとうまさお	斎藤雅雄	人名
さいとうまさひろ	斎藤雅弘	人名
さいとうやたろう	斉藤弥太郎	人名
さいとうゆう	斎藤優	人名
さいとうよへえ	斎藤与兵衛	人名
さえきしゅんすけ	佐伯駿介	人名
さえきよしまさ	佐伯昌優	人名
さかいかずたか	堺和貴	人名
さかいじゅんきち	酒井順吉	人名
さかいすみお	坂井澄夫	人名
さかいとしろう	酒井利郎	人名
さかいのぶや	坂井信哉	人名
さかいひさえん	左海久円	人名
さかいひとみ	坂井仁美	人名
さかいやすのり	坂井康記	人名
さかきばらやすし	榊原靖	人名
さかくらまさのり	坂倉正則	人名
さかぐちさとる	阪口悟	人名
さかぐちのぶひこ	坂口允彦	人名
さかた	阪田	人名
さかたさんきち	阪田三吉	人名
さかのむねかず	坂野宗和	人名
さかのようじ	坂野洋司	人名
さかもとただし	坂本匡	人名
さがらたけし	相良剛史	人名
さきうらまさたか	崎浦正隆	人名
さきやまかずお	先山一雄	人名
さきやまはじめ	崎山元	人名
さくまだいきち	佐久間大吉	人名
さくらいのぼる	桜井昇	人名
さくらいひでたか	櫻井英孝	人名
さくらいりょうじ	桜井亮治	人名
ささきさとし	佐々木聡	人名
ささきしげあき	佐々木成明	人名
ささきしゅういち	佐々木修一	人名
ささきじゅんいち	佐々木純一	人名
ささきただよし	佐々木忠義	人名
ささきだいち	佐々木大地	人名
ささきつよしのり	佐々木雄矩	人名
ささきともなり	佐々木朋成	人名
ささきのぶゆき	佐々木恒之	人名
ささきのりお	佐々木典夫	人名
ささきひろゆき	笹木敬行	人名
ささきまこと	佐々木慎	人名
ささきまさししろう	佐々木政四郎	人名
ささきゆういちろう	佐々木祐一郎	人名
ささきゆうき	佐々木勇気	人名
させゆうじ	佐瀬勇次	人名
さたけのりこ	佐竹典子	人名
さだとみさぶろう	佐田富三郎	人名
さだますみなみ	貞升南	人名
さとうあつし	佐藤厚	人名
さとうかずとし	佐藤和俊	人名
さとうけいいちろう	佐藤佳一郎	人名
さとうけいすけ	佐藤恵介	人名
さとうけんご	佐藤健伍	人名
さとうしゅうじ	佐藤秀司	人名
さとうしょうへい	佐藤庄平	人名
さとうしんいち	佐藤慎一	人名
さとうしんや	佐藤紳哉	人名
さとうたかひこ	佐藤天彦	人名
さとうたくや	佐藤拓也	人名
さとうだいごろう	佐藤大五郎	人名
さとうのぶお	佐藤信雄	人名
さとうはじめ	佐藤啓	人名
さとうひさこ	佐藤寿子	人名
さとうひでかず	佐藤秀和	人名
さとうひろみ	佐藤裕美	人名
さとうまさよし	佐藤正喜	人名
さとうまや	佐藤摩耶	人名
さとうみほ	佐藤美保	人名
さとうやすみつ	佐藤康光	人名
さとうゆういちろう	佐藤雄一郎	人名
さとうゆうき	佐藤優貴	人名
さとうゆたか	佐藤豊	人名
さとうようこ	佐藤陽子	人名
さとうようすけ	佐藤陽介	人名
さとうよしかず	佐藤芳一	人名
さとうよしのり	佐藤義則	人名
さとうよしひこ	佐藤芳彦	人名
さとうよしふみ	佐藤仁史	人名
さとうわたる	佐藤渉	人名
さとみかな	里見香奈	人名
さとみさき	里見咲紀	人名
さなだけいいち	真田圭一	人名
さなだただし	真田正	人名
さなだてっしょう	真田哲章	人名
さのひさし	佐野尚史	人名
さのゆうじ	佐野祐司	人名
さはらちょうじろう	佐原長次郎	人名
さやまさすけ	佐山佐助	人名
さわぐちひろかつ	沢口博勝	人名
さわぐちりょうまこと	澤口諒允	人名
さわだあきひろ	澤田晃宏	人名
さわだしんご	澤田真吾	人名
さわだのりひろ	澤田典宏	人名
さんだいいとうたかしみ	三代伊藤宗看	人名
さんだいおおはしそうけい	三代大橋宗桂	人名
さんだいおおはしたかしあずか	三代大橋宗与	人名
さんまいどうたつや	三枚堂達也	人名
さんわひでき	三和秀樹	人名
しいはしきんじ	椎橋金司	人名
しおだまこと	塩田誠	人名
しおづかずお	塩津一男	人名
しおづこうじ	塩津康司	人名
しげたなおと	重田直人	人名
しげたまさと	重田真人	人名
しげのかずひこ	重野和彦	人名
しげみつぎお	重見次生	人名
しざわはるきち	志沢春吉	人名
しちじようしんたろう	七條慎太郎	人名
しのだまさと	篠田正人	人名
しのはらかずひさ	篠原和久	人名
しのはらようすけ	篠原陽介	人名
しのみやきんご	四宮金吾	人名
しのみやぶんいち	篠宮文一	人名
しばがきひろゆき	柴垣宏至	人名
しばたいえもん	柴田伊右衛門	人名
しばたいのししうえもん	柴田猪右衛門	人名
しばたきひとし	柴田喜斎	人名
しばたてつし	柴田哲志	人名
しばたよくさる	柴田ヨクサル	人名
しばみのる	芝稔	人名
しびかずや	紫尾和也	人名
しぶかわなりょうきち	渋川奈良吉	人名
しぶやいちさぶろう	渋谷市三郎	人名
しぶやまごすけ	渋谷孫助	人名
しぶやもりお	渋谷守生	人名
しまあきら	島朗	人名
しまいさおり	島井咲緒里	人名
しまかわいちのしん	嶋川市之進	人名
しまたつお	島達郎	人名
しまだえいしん	島田永信	人名
しまだきゅうべえ	島田久兵衛	人名
しまだくめきち	島田粂吉	人名
しまだけいのすけ	島田桂之助	人名
しまだけんた	島田健太	人名
しまだゆうすけ	嶋田裕介	人名
しまだよへい	島田與平	人名
しまむらいちろう	島村一郎	人名
しまむらけんいち	島村健一	人名
しまむらますき	島村増喜	人名
しまもとりょう	島本亮	人名
しみずいちよ	清水市代	人名
しみずがみとおる	清水上徹	人名
しみずたかしあん	清水孝晏	人名
しみずとしひろ	清水俊宏	人名
しみずまごいち	清水孫市	人名
しみずゆきすけ	清水幸助	人名
しみずわれはち	清水吾八	人名
しもせいてつしん	下西哲伸	人名
しもだいらまさゆき	下平雅之	人名
しもだいらゆきお	下平幸男	人名
しものたかし	下野貴志	人名
しもやまとものり	下山知徳	人名
しもやまひさお	下山久雄	人名
しゅくそのそうさぶろう	祝薗惣三郎	人名
しゅどうしんいち	首藤信一	人名
しょうがわやすごろう	庄川安五郎	人名
しょうこよしゆき	庄子慶之	人名
しょうじとしゆき	庄司俊之	人名
しょうじひろし	庄司浩	人名
しょうじひろみつ	庄司弘光	人名
しょうじみつひろ	庄司光弘	人名
しょうのたかしさん	庄野喬三	人名
しょしかずはる	所司和晴	人名
しょだいいとうたかしみ	初代伊藤宗看	人名
しょだいおおはしそうけい	初代大橋宗桂	人名
しょだいおおはしたかしあずか	初代大橋宗与	人名
しらいあつお	白井厚男	人名
しらいしまさし	白石雅士	人名
しらいやすひこ	白井康彦	人名
しらいゆうま	白井悠真	人名
しらいよねきち	白井米吉	人名
しらいわいちたろう	白岩市太郎	人名
しらいわたる	白井亘	人名
しらきたかししん	白木崇真	人名
しらすやすしさぶろう	白須泰三郎	人名
しらとりてるよし	白鳥光良	人名
しろぐみ	白組	人名
しろまはるき	城間春樹	人名
しんどうにな	新藤仁奈	人名
しんどうはるみ	新藤春実	人名
しんめいとめきち	新明留吉	人名
じゅういちだいおおはしそうけい	十一代大橋宗桂	人名
じゅうさんきどうやかたどうじょう	十三棋道舘道場	人名
じゅうだいおおはしそうけい	十代大橋宗桂	人名
じゅうにだいおおはしそうきん	十二代大橋宗金	人名
じゅうよしきよひょうえ	住吉清兵衛	人名
じゅうよつやむねやす	十四屋宗安	人名
じようおたけし	城尾武志	人名
じんないかずお	神内和夫	人名
じんぼひだりおおやけ	神保左公	人名
すいつたかよし	水津隆義	人名
すえきちかがまもる	末吉加賀守	人名
すえつぐじゅんいち	末次淳一	人名
すがいたつや	菅井竜也	人名
すぎうらつとうはちろう	杉浦傳八郎	人名
すぎさきさとこ	杉崎里子	人名
すぎしたこうすけ	杉下晃介	人名
すぎしたゆうじ	杉下裕治	人名
すぎのただお	杉野忠夫	人名
すぎのゆたか	杉野豊	人名
すぎはらてつ	杉原徹	人名
すぎはらまつり	杉原茉莉	人名
すぎむらひろゆき	杉村宏之	人名
すぎもとかずお	杉本和陽	人名
すぎもとただお	杉本忠夫	人名
すぎもとちさと	杉本千聡	人名
すぎもとまさたか	杉本昌隆	人名
すずきあつし	鈴木睦	人名
すずきえいしゅん	鈴木英春	人名
すずきかおりげい	鈴木香芸	人名
すずきかつひろ	鈴木勝裕	人名
すずきかんな	鈴木環那	人名
すずきけいいちろう	鈴木桂一郎	人名
すずきけいすけ	鈴木恵介	人名
すずきけんじろう	鈴木健次郎	人名
すずきさだかず	鈴木禎一	人名
すずきじゅんいち	鈴木純一	人名
すずきすすむ	鈴木進	人名
すずきたかゆき	鈴木貴幸	人名
すずきだいすけ	鈴木大介	人名
すずきだんじょうしょうひつ	鈴木弾正少弼	人名
すずきてつごろう	鈴木鉄五郎	人名
すずきてるひこ	鈴木輝彦	人名
すずきのぼる	鈴木昇	人名
すずきひさお	鈴木久男	人名
すずきひろこ	鈴木浩子	人名
すずきまさが	鈴木政賀	人名
すずきまもる	鈴木守	人名
すずきまり	鈴木真里	人名
すずきみがくこう	鈴木琢光	人名
すずきみつる	鈴木満	人名
すずきやすひこ	鈴木康彦	人名
すずきゆうき	鈴木雄貴	人名
すずきゆうこ	鈴木悠子	人名
すずきよしお	鈴木良雄	人名
すずきりさ	鈴木里沙	人名
すずきりょうた	鈴木良太	人名
すとうまんじ	須藤満治	人名
すどまさき	須戸真樹	人名
すながまたさぶろう	須永又三郎	人名
すやまさだじろう	須山定次郎	人名
すわひろし	諏訪寛	人名
せいぐん	西軍	人名
せいのしずお	清野静男	人名
せがわしょうじ	瀬川晶司	人名
せきぐちえいさ	関口英佐	人名
せきぐちかつお	関口勝雄	人名
せきぐちしんご	関口慎吾	人名
せきぐちたけし	関口武史	人名
せきぐちやすお	関口康雄	人名
せきしゅうろくべえ	石州六兵衛	人名
せきじょうてつや	関上哲哉	人名
せきすみのりり	関澄伯理	人名
せきとみつかさおとこ	関富司男	人名
せきねきよこ	関根紀代子	人名
せきねきんじろう	関根金次郎	人名
せきねしげる	関根茂	人名
せきのりよし	関則可	人名
せきはんじ	関半治	人名
せきひでお	関英雄	人名
せきひろし	関浩	人名
せきむかいほうじん	関向邦人	人名
せきやきよさく	関屋喜代作	人名
せとがわともか	瀬戸川智香	人名
せとひろはる	瀬戸博晴	人名
せらつかさ	瀬良司	人名
せりざわひろふみ	芹沢博文	人名
せりたおさむ	芹田修	人名
せんざきまなぶ	先崎学	人名
せんついたかこ	泉對貴子	人名
せんついなおこ	泉對直子	人名
そうませいじ	相馬清司	人名
そうまみさき	相馬美咲	人名
そえだむねたおっと	添田宗太夫	人名
そねふみひと	曽根史仁	人名
そねやすまさ	曽根康昌	人名
そのだあきお	園田章雄	人名
たいましげあき	大麻重明	人名
たいらのぶひろ	平伸弘	人名
たかがきとしお	高垣登志雄	人名
たかぎけい	高木啓	人名
たかぎこういち	高木孝一	人名
たかぎさとし	高木聡	人名
たかぎしゅうじ	高木修治	人名
たかぎそのき	高木其木	人名
たかぎたつお	高木達夫	人名
たかぎとよぞう	高木豊蔵	人名
たかぎひであき	高木秀彰	人名
たかぎひとし	高木均	人名
たかざきいっせい	高崎一生	人名
たかしかあきらさち	高鹿照祥	人名
たかしまかずきよ	高島一岐代	人名
たかしまかずよしふなと	高島一由岐	人名
たかしまただしごろう	高島直五郎	人名
たかしまひろみつ	高島弘光	人名
たかしまやさぶろう	高島弥三郎	人名
たかだいわじろう	高田岩二郎	人名
たかだしょうへい	高田尚平	人名
たかだたけし	高田丈資	人名
たかのあきと	高野明人	人名
たかのあきらとみ	高野明富	人名
たかのさとし	高野悟志	人名
たかのさとし	高野智史	人名
たかのひでゆき	高野秀行	人名
たかのやすしかおる	高野靖薫	人名
たかはしけん	高橋賢	人名
たかはししげゆき	高橋茂行	人名
たかはしじゅん	高橋淳	人名
たかはしじょうのすけ	高橋錠之助	人名
たかはしせいじ	高橋誠司	人名
たかはしちゅうじろう	高橋忠次郎	人名
たかはしとうじろう	高橋藤次郎	人名
たかはしとおる	高橋徹	人名
たかはしとしいく	高橋利育	人名
たかはしのりゆき	高橋範行	人名
たかはしはるお	高橋治雄	人名
たかはしひであき	高橋英晃	人名
たかはしひろし	高橋博司	人名
たかはしみちお	高橋道雄	人名
たかはしみちかど	高橋道角	人名
たかはしやまと	高橋和	人名
たかはたせいじ	高畑誠司	人名
たかはねけん	鷹羽賢	人名
たかはまあいこ	高浜愛子	人名
たかはまさくぞう	高浜作蔵	人名
たかはまただし	高浜禎	人名
たかはまとしお	高浜敏夫	人名
たかむらとくじろう	高村徳次郎	人名
たかむれさちこ	高群佐知子	人名
たかやしんや	高谷新也	人名
たかやなぎかおる	高柳馨	人名
たかやなぎとしお	高柳敏夫	人名
たかやまたけきち	高山丈吉	人名
たがしらりょうたろう	田頭亮太郎	人名
たがつねよう	多賀常容	人名
たがわのぶゆき	田川信之	人名
たきざわだいち	滝澤大地	人名
たきざわだいち	瀧澤大地	人名
たきせいいちろう	滝誠一郎	人名
たきまさひろ	瀧正裕	人名
たきもとひろみつ	瀧本洋満	人名
たきもとふとし	滝源太	人名
たぐちせいいちろう	田口誠一郎	人名
たけいさくぞう	武井作蔵	人名
たけいちさぶろう	武市三郎	人名
たけうちうしまつ	竹内丑松	人名
たけうちさちよ	竹内幸代	人名
たけうちたいご	竹内大悟	人名
たけうちたかひろ	竹内貴浩	人名
たけうちてつや	竹内哲也	人名
たけうちとしお	竹内俊男	人名
たけうちとしひろ	竹内俊弘	人名
たけうちながばやし	竹内長林	人名
たけうちひろし	竹内大史	人名
たけうちひろし	竹内洋志	人名
たけうちまんぞう	竹内万蔵	人名
たけうちゆうご	竹内雄悟	人名
たけうちゆずるつかさ	武内譲司	人名
たけうちようじ	竹内洋次	人名
たけざわそうし	竹沢総司	人名
たけだかずま	武田一馬	人名
たけだこうじ	武田浩司	人名
たけだしゅんぺい	武田俊平	人名
たけだよしひろ	武田嘉弘	人名
たけちまこと	武智誠	人名
たけなかけんいち	竹中健一	人名
たけはらたかしあつし	竹原隆毅	人名
たけべさゆり	竹部さゆり	人名
たけべわかお	建部和歌夫	人名
たけまさはくしゅう	武政伯周	人名
たけまたべに	竹俣紅	人名
たけみやまさき	武宮正樹	人名
たけむらこうせい	竹村康正	人名
たけむらとしお	武村俊夫	人名
たけむらひろあき	竹村孔明	人名
たけもとじさえもん	竹本次左衛門	人名
たけもとよしお	武本義雄	人名
たけやまとしお	武山俊夫	人名
たこじまあきこ	蛸島彰子	人名
たしろすすむ	田代将	人名
たじまじょう	田嶋尉	人名
たじまひさと	田島寿人	人名
たじままさあき	田島正章	人名
たじりたかし	田尻隆司	人名
たたのまもる	多々納守	人名
ただよしこ	多田佳子	人名
たちまさみつ	達正光	人名
たつみえいじ	巽映治	人名
たつみきよじ	辰巳喜代治	人名
たつみこうじろう	巽浩二郎	人名
たていしかつみ	立石勝巳	人名
たていしかつみ	立石活巳	人名
たていしわたる	立石径	人名
たてわきけいいち	立脇敬一	人名
たなかあきお	田中明郎	人名
たなかかいしゅう	田中魁秀	人名
たなかくにあき	田中邦明	人名
たなかけいき	田中景季	人名
たなかこうじろう	田中幸次郎	人名
たなかじゅんひこ	田中巡彦	人名
たなかじゅんり	田中順理	人名
たなかたけじろう	田中武次郎	人名
たなかたけじろう	田中竹次郎	人名
たなかただかつ	田中忠勝	人名
たなかとしお	田中敏夫	人名
たなかとらひこ	田中寅彦	人名
たなかのりた	田中憲太	人名
たなかひろし	田中浩	人名
たなかひろみ	田中博己	人名
たなかまこと	田中誠	人名
たなかまさのぶ	田中正信	人名
たなかまさのり	田中雅典	人名
たなかまさはる	田中雅治	人名
たなかみつじろう	田中光次郎	人名
たなかみやつこ	田中造	人名
たなかもへい	田中茂兵衛	人名
たなかやすし	田中保	人名
たなかゆういち	田中悠一	人名
たなかゆきみち	田中幸道	人名
たなかよしひさ	田中佳久	人名
たなかよしみやつこ	田中善造	人名
たなせしょうぎ	棚瀬将棋	人名
たなだまゆみ	棚田真由美	人名
たなはしすすむ	棚橋進	人名
たなべいちろう	田辺一郎	人名
たなべいっかく	田辺一鶴	人名
たなべかつゆき	田辺克行	人名
たなべけい	田辺圭	人名
たにあいひろしきの	谷合廣紀	人名
たにかおる	谷馨	人名
たにかわはるえ	谷川治恵	人名
たにがしらきすけ	谷頭喜祐	人名
たにがわおさむめぐみ	谷川治惠	人名
たにがわかつとし	谷川勝敏	人名
たにがわこうじ	谷川浩司	人名
たにがわとしあき	谷川俊昭	人名
たにさきおみがく	谷崎生磨	人名
たにはたやすひこ	谷畑安彦	人名
たにもとせいいち	谷本誠一	人名
たねむらもとむ	種村求	人名
たはらつるのすけ	田原鶴之助	人名
たばたりょうた	田畑良太	人名
たまいしょうき	玉井将貴	人名
たまいじゅん	玉井純	人名
たまいみちお	玉井三千雄	人名
たまきつかさ	玉城司	人名
たまだたままど	玉田玉窓	人名
たまつたかひろ	玉津高広	人名
たまるのぼる	田丸昇	人名
たみわよしたか	民輪義孝	人名
たむらこういち	田村幸一	人名
たむらこうすけ	田村康介	人名
たむらすみや	田村純也	人名
たむらたくみ	田村拓未	人名
たんごひでかず	丹後秀一	人名
たんはるあき	丹治昭	人名
だいえいこう	戴永康	人名
だいまつけいじ	大松啓治	人名
だてやすお	伊達康夫	人名
だんおにろく	団鬼六	人名
ちかなりけんいち	近成憲一	人名
ちかむらいっき	近村一輝	人名
ちかむらゆきみち	近村幸道	人名
ちくぜんげんえもん	筑前源右衛門	人名
ちくぜんひゃくすけ	筑前百助	人名
ちだしょうた	千田翔太	人名
ちはらきはち	千原喜八	人名
ちばきよし	千葉聖	人名
ちばごろう	千葉五郎	人名
ちばさきお	千葉幸生	人名
ちばなけん	知花賢	人名
ちばりょうこ	千葉涼子	人名
ちゃいゆきひろ	茶位幸弘	人名
ちゅうざまこと	中座真	人名
ちゅうじょうはんひろ	中條範広	人名
ちょうこくさかえ	趙国栄	人名
ちょうせいはるひこ	長生治彦	人名
つかだまさお	塚田正夫	人名
つかだやすあき	塚田泰明	人名
つかのよしかず	塚野良和	人名
つかもとてるあき	塚本輝昭	人名
つかもとまさお	塚本正雄	人名
つかもとゆき	塚本裕貴	人名
つきがたりゅうのすけ	月形竜之介	人名
つじかげふみ	辻景文	人名
つじきよじ	辻清治	人名
つじしげのすけ	辻繁之助	人名
つじせいぞう	辻精三	人名
つじたかとし	辻隆敏	人名
つじたともあき	辻田智秋	人名
つじのうちかつなり	辻ノ内克成	人名
つじやぞう	辻弥蔵	人名
つじゆうすけ	辻裕介	人名
つじわけりょうひこ	辻分亮彦	人名
つだいくじろう	津田幾次郎	人名
つだこうじ	津田功司	人名
つだひなたもり	津田日向守	人名
つだふじ	津田富士	人名
つだまさひろ	津田昌宏	人名
つちもちそうへい	土持総平	人名
つちやそうせい	土屋奏生	人名
つづきしんべい	都築新兵衛	人名
つねたにまこと	常谷誠	人名
つねまつたかふみ	恒松鷹史	人名
つぼいさだいち	坪井定一	人名
つぼいつくりみち	坪井作道	人名
つぼうちつくりみち	坪内作道	人名
つぼうちとしゆき	坪内利幸	人名
つぼたなおあき	坪田直明	人名
つぼやたへいあきら	坪屋太兵瑛	人名
つむぎゆうき	紬勇気	人名
つむらつねよし	津村常吉	人名
つやましんご	津山慎悟	人名
ていたまきはな	鄭環華	人名
てつかもとじろう	手塚本次郎	人名
てらいまつさだ	寺井松貞	人名
てらおまさかず	寺尾正和	人名
てらしたのりこ	寺下紀子	人名
てらしままさゆき	寺嶋眞之	人名
てらだあきお	寺田昭夫	人名
てらだあさじろう	寺田浅次郎	人名
てらだうめきち	寺田梅吉	人名
てらだけいざぶろう	寺田慶三郎	人名
てんまや	天満屋	人名
でぐちゆうだい	出口雄大	人名
でざわひろき	出澤浩樹	人名
でとえいいちろう	出戸英一郎	人名
でんたよしひろ	傳田芳裕	人名
といだよしまさ	樋田栄正	人名
とうぐん	東軍	人名
とうだなおたか	任田有孝	人名
とうないげんざぶろう	藤内源三郎	人名
とうないしのぶ	藤内忍	人名
とうのてつお	東野徹男	人名
とうまなつこ	藤間菜津子	人名
とえだこういち	戸枝晃一	人名
とおやまながとし	遠山長年	人名
とおやまゆうすけ	遠山雄亮	人名
とがしたかし	富樫充	人名
ときたかつひろ	土岐田勝弘	人名
ときたけいざぶろう	時田慶三郎	人名
ときたたけお	時田武夫	人名
とくいまさゆき	徳井優之	人名
とくがわいえはる	徳川家治	人名
とくたけかつじ	徳竹勝治	人名
とくたけげんき	徳竹元気	人名
とくだけんし	徳田拳士	人名
とくながよしひろ	徳永吉宏	人名
とくはらせんたく	徳原千拓	人名
とさこうじ	土佐浩司	人名
としまたつやま	豊島龍山	人名
としまたろうきち	豊島太郎吉	人名
となりりゅうま	都成竜馬	人名
とのおかゆり	殿岡裕里	人名
とばしせいじ	都橋政司	人名
とべまこと	戸辺誠	人名
とみおかえいさく	富岡英作	人名
とみざわみきお	富沢幹雄	人名
とやましげる	外山茂	人名
とよかわたかひろ	豊川孝弘	人名
とよしままさゆき	豊島将之	人名
とよだきへえ	豊田喜兵衛	人名
とよだしろうさぶろう	豊田四郎三郎	人名
とよだなつみ	豊田奈都美	人名
とよだやすゆき	豊田康之	人名
とりいよね	鳥居よね	人名
どいいちたろう	土居市太郎	人名
どいはるさゆう	土井春左右	人名
どいふみお	土居文雄	人名
どいまさる	土井勝	人名
どうじまえいぞう	堂島栄造	人名
どばしけんいち	土橋健一	人名
どばしじゅんろう	土橋惇郎	人名
どばしみなこ	土橋美奈子	人名
どばしよしたか	土橋吉孝	人名
ないとうあつみ	内藤敦海	人名
ないとうかんよう	内藤寛洋	人名
ないとうくにお	内藤國雄	人名
ないとうだいすけ	内藤大助	人名
ないとうひであき	内藤秀彰	人名
なかい	中井	人名
なかいすてきち	中井捨吉	人名
なかいひろえ	中井広恵	人名
なかいりんふとし	中井麟太	人名
なかえまなぶゆう	中江学雄	人名
なかおおさむ	中尾修	人名
なかおとしゆき	中尾敏之	人名
なかがわけいご	中川慧梧	人名
なかがわしゅんいち	中川俊一	人名
なかがわだいすけ	中川大輔	人名
なかがわとみいし	中川富石	人名
なかくらあきこ	中倉彰子	人名
なかくらひろみ	中倉宏美	人名
なかぐまとらお	中熊寅雄	人名
なかざわさや	中澤沙耶	人名
なかざわひろし	仲澤宏史	人名
なかざわゆうき	仲澤雄貴	人名
なかじまおさむひょうえ	中島治兵衛	人名
なかじまかずえ	中島主計	人名
なかじまきよし	中島清	人名
なかじますすむ	中島進	人名
なかじまたいぞう	中島大蔵	人名
なかじまだいぜん	中島大膳	人名
なかじままり	中島真理	人名
なかじまゆき	中島裕貴	人名
なかじまりょうすけ	中島量助	人名
なかせこだいらおさむ	中瀬小平治	人名
なかそねあつや	中曽根敦也	人名
なかたいさお	中田功	人名
なかたしょうどう	中田章道	人名
なかたにしげる	中谷茂	人名
なかたにじゅんこ	中谷純子	人名
なかたにたくや	中谷拓也	人名
なかたひろき	中田宏樹	人名
なかたよしふみ	中田喜文	人名
なかななみ	中七海	人名
なかにしたもつ	中西保	人名
なかにしひろじ	中西弘次	人名
なかにしひろまさ	中西浩正	人名
なかねし	中根氏	人名
なかのあやこ	中野綾子	人名
なかのしちろうち	中野七郎治	人名
なかのたいすけ	中野太輔	人名
なかのともひろ	中野智弘	人名
なかのひろぶみ	中野博文	人名
なかのまさふみ	中野雅文	人名
なかのゆうすすむ	仲野祐進	人名
なかのゆうた	中野勇太	人名
なかはらこころざしきゅう	中原志九	人名
なかはらしまる	中原志丸	人名
なかはらつねお	中原恒夫	人名
なかはらまこと	中原誠	人名
なかばやしきへえ	中林喜兵衛	人名
なかひらたかまさ	中平貴将	人名
なかひらやすし	中平寧	人名
なかひらよしもと	中平良基	人名
なかふじまこと	中藤誠	人名
なかぼうきんぞう	中坊金蔵	人名
なかむらいちろう	中村一朗	人名
なかむらおさむ	中村修	人名
なかむらきょう	中村恭	人名
なかむらきよし	中村清志	人名
なかむらくまじ	中村熊治	人名
なかむらけいご	中村圭吾	人名
なかむらしょうべえ	中村庄兵衛	人名
なかむらたいち	中村太地	人名
なかむらたかふみ	中村貴史	人名
なかむらたかゆき	中村孝幸	人名
なかむらただお	中村忠雄	人名
なかむらだいすけ	中村大輔	人名
なかむらちひろ	中村千尋	人名
なかむらつねまこと	中邨常誠	人名
なかむらともよし	中村知義	人名
なかむらひろひさ	中村洋久	人名
なかむらまさひと	中村真史	人名
なかむらまりか	中村真梨花	人名
なかむらももこ	中村桃子	人名
なかむらゆうすけ	中村裕介	人名
なかむらりょうすけ	中村亮介	人名
なかもとかずや	中本一弥	人名
なかやまえいたちばな	中山英橘	人名
なかやまかんざぶろう	中山勘三郎	人名
なかやまのりお	中山則男	人名
ながいさくら	永井さくら	人名
ながいよしひろ	永井義博	人名
ながいよしみ	永井嘉	人名
ながおかとしかつ	長岡俊勝	人名
ながおかゆうや	長岡裕也	人名
ながおかようへい	長岡洋平	人名
ながおたかひろ	長尾崇弘	人名
ながさかろくのすけ	長坂六之助	人名
ながさくよしなり	永作芳也	人名
ながさわかつお	永沢勝雄	人名
ながさわただひろ	長沢忠宏	人名
ながさわちかこ	長沢千和子	人名
ながしままこと	長嶋誠	人名
ながせたくや	永瀬拓矢	人名
ながたえみ	永田恵実	人名
ながたきょうこ	永田香子	人名
ながたけいいちろう	永田圭一郎	人名
ながたけんいち	永田憲一	人名
ながたにきょうみん	長谷興民	人名
ながたにひさこ	長谷久子	人名
ながたひろみち	長田博道	人名
ながたまさこ	永田雅子	人名
ながたまさのぶ	永田雅信	人名
ながたよしろう	長田嘉郎	人名
ながつゆひでお	永露英郎	人名
ながぬまひろし	長沼洋	人名
ながはししげお	長橋重雄	人名
ながもりひろゆき	永森広幸	人名
なごやあきらゆう	名越照祐	人名
なだみつる	名田満	人名
なだれんしょう	灘蓮照	人名
ななよいとうむねひさ	七代伊藤宗寿	人名
ななよおおはしそうけい	七代大橋宗桂	人名
ななよおおはしたかしあずか	七代大橋宗与	人名
なみへいわこころざし	波平和志	人名
なめかたひさし	行方尚史	人名
ならさきしんじろう	楢先新次郎	人名
ならさきしんじろう	楢崎新次郎	人名
ならしゅんいち	奈良俊一	人名
ならときお	奈良時男	人名
なりしまれいつな	成島令綱	人名
なりたえいじ	成田英二	人名
なりたきみちか	成田公哉	人名
なりたしょういち	成田正一	人名
なりたのりとし	成田憲俊	人名
なりたみほ	成田弥穂	人名
なるせみちのり	成瀬道紀	人名
なんばはるか	難波遥香	人名
にしいちたろう	西市太郎	人名
にしおあきら	西尾明	人名
にしおりゅうたろう	西尾龍太郎	人名
にしかわかずひろ	西川和宏	人名
にしかわかずひろ	西川和弘	人名
にしかわきょうへい	西川恭平	人名
にしかわけいじ	西川慶二	人名
にしかわけんたろう	西川権太郎	人名
にしかわたいじ	西川太二	人名
にしきおりちゅうぞう	錦織忠蔵	人名
にしざわあきら	西沢章	人名
にしじゆんぺい	西淳平	人名
にしたにあきお	西谷明雄	人名
にしだたくや	西田拓也	人名
にしのけん	西野剣	人名
にしはらだいじく	西原大軸	人名
にしむらかずよし	西村一義	人名
にしむらけいご	西村佳悟	人名
にしむらふみと	西村文登	人名
にしむらまさき	西村正毅	人名
にしむらみちはる	西村道治	人名
にしもとかおる	西本馨	人名
にしもとけいすけ	西本慶輔	人名
にしもとたろう	西本太郎	人名
にしもりひろししろう	西森紘四郎	人名
にしやまともか	西山朋佳	人名
にしやまみのる	西山実	人名
にだいいとうそういん	二代伊藤宗印	人名
にだいおおはしそうこ	二代大橋宗古	人名
にわけんじ	丹羽健二	人名
ぬまはるお	沼春雄	人名
ねぎしいさむ	根岸勇	人名
ねごろせいじろう	根来清次郎	人名
ねごろまさひろ	根来正浩	人名
ねほたくや	禰保拓也	人名
のぐちしずお	野口鎮生	人名
のぐちしゅんじ	野口俊二	人名
のぐちそうし	野口壮士	人名
のぐちただお	野口忠雄	人名
のぐちへいたろう	野口平太郎	人名
のぐちよしみ	野口義美	人名
のさきまさたかし	野崎雅敬	人名
のさきよしたろう	野崎由太郎	人名
のじまたかひろ	野島崇宏	人名
のだけいぞう	野田敬三	人名
のださわあやの	野田澤彩乃	人名
のだひろゆき	野田裕之	人名
のづきひろたか	野月浩貴	人名
のとうおおとりゆう	野藤鳳優	人名
のとうみつじ	野藤光史	人名
のなかたく	野中卓	人名
のばつよししげる	野場敢滋	人名
のぶさわひであき	信沢英明	人名
のぶとうちょうべえ	信藤長兵衛	人名
のぼりかりえいすけ	登加利永祐	人名
のまとしかつ	野間俊克	人名
のむらこうじ	野村幸司	人名
のむらしげる	野村茂	人名
のむらよしとら	野村慶虎	人名
のもととらつぐ	野本虎次	人名
のやまともたか	野山知敬	人名
はがたあきら	羽賀田明	人名
はぎたしげじろう	萩田重次郎	人名
はぎたしげひで	萩田重栄	人名
はぎのまほ	萩野真甫	人名
はぎのりょうさえもん	萩野良左衛門	人名
はぎわらじゅん	萩原淳	人名
はぐらまさとし	羽倉昌利	人名
はししたきよし	橋下清志	人名
はしづめとしたろう	橋爪敏太郎	人名
はしばとものり	橋場友則	人名
はしもとかんじろう	橋本官次郎	人名
はしもとかんじろう	橋本寛次郎	人名
はしもとくにお	橋本国雄	人名
はしもとさんじ	橋本三治	人名
はしもとたかのり	橋本崇載	人名
はしもとちかこ	橋本智佳子	人名
はしもとひでき	橋本英樹	人名
はしもとひゃくかつら	橋本百桂	人名
はしもとまき	橋本真季	人名
はしもとまどか	橋本瞬	人名
はしもとやすお	橋本康男	人名
はしもとよしはる	橋本喜晴	人名
はしもとらんさかえ	橋本蘭栄	人名
はしもとらんしゅう	橋本蘭秀	人名
はしりっしょうだい	橋立正大	人名
はせがわいくお	長谷川郁夫	人名
はせがわしろうさえもん	長谷川四郎左衛門	人名
はせがわせいじろう	長谷川清二郎	人名
はせがわぜんたろう	長谷川善太郎	人名
はせがわひろし	長谷川裕	人名
はせがわみのる	長谷川稔	人名
はせがわゆうき	長谷川優貴	人名
はせべこうへい	長谷部浩平	人名
はせべひさお	長谷部久雄	人名
はぜがわじゅん	長谷川潤	人名
はたあきこ	畑曉子	人名
はたかなみ	畑香奈美	人名
はたけやまだいき	畠山大樹	人名
はたけやまなるゆき	畠山成幸	人名
はたけやままもる	畠山鎮	人名
はたなかけんご	畑中謙吾	人名
はたなかさゆり	畑中さゆり	人名
はちだいいとうそういん	八代伊藤宗印	人名
はちだいおおはしそうけい	八代大橋宗桂	人名
はったたかひろ	初田隆宏	人名
はったよしあき	初田義明	人名
はっとりしょうじろう	服部庄次郎	人名
はなおかてつふみ	花岡哲文	人名
はなさきときのすけ	花崎時之助	人名
はなぞのみのる	花園稔	人名
はなたしょういち	花田尚一	人名
はなだちょうたろう	花田長太郎	人名
はなむらもとじ	花村元司	人名
はなわまさあき	花輪正明	人名
はねかわだけ	羽川岳	人名
はひであき	葉秀明	人名
はぶゆくえやまざき	羽生行方山崎	人名
はぶよしはる	羽生善治	人名
はまだゆたか	浜田豊	人名
はまなかたかのり	濱中孝徳	人名
はまなかたかのり	濱仲孝徳	人名
はまなやきち	浜名弥吉	人名
はまのとものり	濱野智徳	人名
はまのゆたか	浜野豊	人名
はままさゆき	浜真之	人名
はやかわしゅん	早川俊	人名
はやかわたかのり	早川隆教	人名
はやさきまさかず	早咲誠和	人名
はやしこういち	林孝一	人名
はやしこういち	林浩一	人名
はやしさなえ	林沙苗	人名
はやししんいち	林眞一	人名
はやしせいいち	林清一	人名
はやしたかしはち	林節八	人名
はやしたかひろ	林隆弘	人名
はやしばなおこ	林葉直子	人名
はやしへいすけ	林平助	人名
はやしまさと	林正人	人名
はやしまゆみ	林まゆみ	人名
はやしりゅういち	林隆一	人名
はやみずちさ	早水千紗	人名
はらおかじゅんいちろう	原岡純一郎	人名
はらきうえもん	原喜右衛門	人名
はらたばなとおる	原田花暢	人名
はらだたかのり	原田隆範	人名
はらだやすお	原田泰夫	人名
はらだゆうや	原田祐也	人名
ばばたかゆき	馬場孝幸	人名
ばんどうあきらろう	坂東明朗	人名
ばんどうかなこ	坂東香菜子	人名
ひいらぎよしのすけ	柊吉之助	人名
ひうらいちろう	日浦市郎	人名
ひおきいつへいまもる	日置五兵衛	人名
ひがきこれやす	檜垣是安	人名
ひがしこうへい	東公平	人名
ひぐちたつじろう	樋口辰次郎	人名
ひぐちたつや	樋口達也	人名
ひぐちよしお	樋口義雄	人名
ひぐまふみお	樋熊文夫	人名
ひさたやさぶろう	久田弥三郎	人名
ひさつともこ	久津知子	人名
ひさつひろゆき	久津弘行	人名
ひさつよいち	久津世一	人名
ひしだまさよし	菱田正泰	人名
ひしやさとしさぶろう	菱谷智三郎	人名
ひむかしひでたけ	日昔秀岳	人名
ひょうどうけいいち	兵頭慶一	人名
ひらいずみたけし	平泉丈志	人名
ひらいとらきち	平居寅吉	人名
ひらいわあゆみかつら	平岩歩桂	人名
ひらいわごうすけ	平岩郷助	人名
ひらいわよねきち	平岩米吉	人名
ひらかわおさむ	平川修	人名
ひらがしきぶしょうほ	平賀式部少輔	人名
ひらさわちょうきち	平澤長吉	人名
ひらさわりさ	平澤理沙	人名
ひらしまけん	平島賢	人名
ひらしまぜんすけ	平島善助	人名
ひらしまだいすけ	平島大介	人名
ひらたさなえ	平田早苗	人名
ひらたちゅうすけ	平田忠助	人名
ひらたりゅうき	平田竜樹	人名
ひらつかきうえもん	平塚喜右衛門	人名
ひらのしんすけ	平野信助	人名
ひらのしんたろう	平野慎太郎	人名
ひらのひろきち	平野広吉	人名
ひらのまみ	平野眞三	人名
ひらはたぜんすけ	平畑善介	人名
ひらふじしんご	平藤眞吾	人名
ひらふじしんご	平藤真吾	人名
ひらもとしげる	平本茂	人名
ひるかわあつし	蛭川敦	人名
ひろせあきひと	広瀬章人	人名
ひろせしゅういち	広瀬修市	人名
ひろせじゅうへい	広瀬重平	人名
ひろつひさお	広津久雄	人名
ひろにわちゅうしょ	広庭中書	人名
ひろのじんきちしろう	廣野甚四郎	人名
ふかいかずのぶ	深井一伸	人名
ふかいまごひら	深井孫平	人名
ふかうら	深浦	人名
ふかうらこういち	深浦康市	人名
ふかづかおるしろう	深津馨四郎	人名
ふかのうへえ	深野宇兵衛	人名
ふかのまごへいまもる	深野孫兵衛	人名
ふかまちけんいち	深町賢一	人名
ふくいやつばさ	福井谷翼	人名
ふくいよしひろ	福井善博	人名
ふくおかひさいち	福岡久一	人名
ふくさきぶんご	福崎文吾	人名
ふくさきむつみ	福崎睦美	人名
ふくしまこうはち	福島幸八	人名
ふくしまじゅんき	福島順喜	人名
ふくしままんひょうえ	福島万兵衛	人名
ふくせんふじよし	福泉藤吉	人名
ふくださだじろう	福田定次郎	人名
ふくだはくしょうさい	福田箔昇斎	人名
ふくながしゅういち	福永修一	人名
ふくはらやすし	普久原安	人名
ふくまけんた	福間健太	人名
ふくまたかと	福間貴斗	人名
ふくもとたかひろ	福本孝博	人名
ふくもとゆういち	福本雄一	人名
ふくやまひであき	福山英明	人名
ふしやかつひろ	伏屋克洋	人名
ふじいけいこ	藤井敬子	人名
ふじいしんじ	藤井真司	人名
ふじいたけし	藤井猛	人名
ふじいのぶゆき	藤井暢之	人名
ふじいまさのり	藤井政範	人名
ふじいまっさきおおひら	藤井先崎大平	人名
ふじいようこ	藤井洋子	人名
ふじいよしひさ	藤井佳久	人名
ふじうちきんご	藤内金吾	人名
ふじおかあきひこ	藤岡章彦	人名
ふじおかはやた	藤岡隼太	人名
ふじかわきよみ	藤川清美	人名
ふじかわよしお	藤川義夫	人名
ふじくらゆうき	藤倉勇樹	人名
ふじさわくらのすけ	藤澤庫之助	人名
ふじしろさぶろう	藤代三郎	人名
ふじすみのぶひろ	藤隅信宏	人名
ふじたあや	藤田綾	人名
ふじたあらふとし	藤田荒太	人名
ふじたかずあき	藤田一暁	人名
ふじたかずき	藤田一樹	人名
ふじたかつらりつ	藤田桂立	人名
ふじたきよしさぶろう	藤田清三郎	人名
ふじたしょういち	藤田彰一	人名
ふじたたかし	藤田貴史	人名
ふじたひこうもん	藤田彦右門	人名
ふじたまいこ	藤田麻衣子	人名
ふじたまさし	藤田雅志	人名
ふじたりんし	藤田倫史	人名
ふじもとそうたろう	藤本壮太郎	人名
ふじもとひろゆき	藤本裕行	人名
ふじもとまさふみ	藤本正文	人名
ふじもりそうたろう	藤森壮太郎	人名
ふじもりたもつ	藤森保	人名
ふじもりてつや	藤森哲也	人名
ふじもりなつこ	藤森奈津子	人名
ふじやまじゅんいち	藤山順一	人名
ふじわらたかこ	藤原崇子	人名
ふじわらなおや	藤原直哉	人名
ふじわらゆうぞう	藤原雄三	人名
ふじわらゆき	藤原結樹	人名
ふせくにひこ	布施邦彦	人名
ふたかみたつや	二上達也	人名
ふたみけいぞう	二見敬三	人名
ふなえこうへい	船江恒平	人名
ふなととしろう	船登俊朗	人名
ふなとようこ	船戸陽子	人名
ふなばしいちくん	船橋一訓	人名
ふなやままさお	舟山正夫	人名
ふねやましょう	舟山正	人名
ふるかわあやこ	古河彩子	人名
ふるかわゆうだい	古川祐大	人名
ふるさわひであき	古沢秀明	人名
ふるやしんいち	古矢慎一	人名
ふるやゆきひろ	古谷幸大	人名
へいじりょう	平次良	人名
へんみすま	辺見寿満	人名
べっしょもとあん	別所素庵	人名
ほしだけいぞう	星田啓三	人名
ほしであきら	星出明	人名
ほしのけんいち	星野健一	人名
ほしのよしたか	星野良生	人名
ほしのよしひと	星野義人	人名
ほしのりゅういちろう	星野隆一郎	人名
ほしみやけん	星宮謙	人名
ほそいよしたつ	細井義竜	人名
ほそかわだいいちろう	細川大市郎	人名
ほそだきよひで	細田清英	人名
ほそだへいぞう	細田平蔵	人名
ほそだみぎせん	細田右仙	人名
ほそはらかずお	細原一夫	人名
ほそみかずお	細見和雄	人名
ほそやまさき	細谷正紀	人名
ほつたひさとせい	堀田久里生	人名
ほばらかもさえもん	保原加茂左衛門	人名
ほりいくにあき	堀井邦明	人名
ほりいじゆんじ	堀井淳之	人名
ほりかわえいふ	堀川英歩	人名
ほりかわおさむ	堀川修	人名
ほりぐちかずしざ	堀口一史座	人名
ほりぐちこうじ	堀口弘治	人名
ほりまさのり	堀正典	人名
ほんいんぼうさんさ	本因坊算砂	人名
ほんいんぼうしゅうかおる	本因坊秀芳	人名
ほんだけいじ	本田啓二	人名
ほんださゆり	本田小百合	人名
ほんだふとし	本田太	人名
ほんぼうかずや	本坊和也	人名
ほんまそうえつ	本間爽悦	人名
ほんまひであき	本間秀晃	人名
ほんまひろし	本間博	人名
ほんまゆうじ	本間悠司	人名
まいざかきよとみ	前坂清富	人名
まえかわしょうぞう	前川尚三	人名
まえかわたくじ	前川琢治	人名
まえかわひでき	前川英己	人名
まえかわまんぞう	前川万蔵	人名
まえだあきら	前田亮	人名
まえだあきらけん	前田明賢	人名
まえだえいふ	前田英歩	人名
まえだじゅんき	前田順喜	人名
まえだましゅう	前田真周	人名
まえだやすなり	前田泰成	人名
まえだやすひろ	前田泰宏	人名
まえだゆうじ	前田祐司	人名
まかべえりこ	真壁栄理子	人名
まがらけいいち	真柄恵一	人名
まがりぶちかいのかみ	曲淵甲斐守	人名
まきたはじめ	蒔田元	人名
まきのまさき	牧野正紀	人名
まきのみつのり	牧野光則	人名
まきのよしのり	真木野芳紀	人名
まきのよしはる	牧野良治	人名
まきろくじろう	牧六次郎	人名
まことはちてっ	眞鉢徹	人名
まさおかすみお	正岡寿美男	人名
ましまみずほはく	馬島瑞伯	人名
まじまたかし	真島隆志	人名
ますおかそうじろう	増岡惣次郎	人名
ますだこうぞう	升田幸三	人名
ますだとしじ	増田敏二	人名
ますだやすひろ	増田康宏	人名
ますだゆうじ	増田裕司	人名
ますだゆうすけ	桝田悠介	人名
ますもとたかし	増本敬	人名
ませかつじろう	間瀬勝次郎	人名
まちだかずや	町田和也	人名
まついこうじろう	松井耕次郎	人名
まついさんきち	松井三吉	人名
まついたくや	松井卓哉	人名
まついゆたかひとし	松井豊仁	人名
まついよしのぶ	松井義信	人名
まつうらしょうぞう	松浦省三	人名
まつうらたくぞう	松浦卓造	人名
まつうらたつや	松浦辰弥	人名
まつうらなおき	松浦直樹	人名
まつうらまさずみ	松浦将純	人名
まつうらゆうこ	松浦友子	人名
まつうらりゅういち	松浦隆一	人名
まつえだよしえ	松枝淑恵	人名
まつおあゆむ	松尾歩	人名
まつおかおり	松尾香織	人名
まつおかむねよし	松岡宗悦	人名
まつおてつや	松尾哲也	人名
まつおとものり	松尾知典	人名
まつおやすゆき	松尾康之	人名
まつさかふくしろう	松坂福四郎	人名
まつしたおきもり	松下隠岐守	人名
まつしたくろうど	松下蔵人	人名
まつしたつとむ	松下力	人名
まつしまひでゆき	松島秀幸	人名
まつだあきらりん	松田章林	人名
まつだあつし	松田敦志	人名
まつだいらそうさえもん	松平宗左衛門	人名
まつだかずひこ	松田一彦	人名
まつだこうじ	松田耕治	人名
まつだしげゆき	松田茂役	人名
まつだたかし	松田隆	人名
まつだたつお	松田辰雄	人名
まつだなおこ	松田直子	人名
まつだひろし	松田博志	人名
まつだまさお	松田政雄	人名
まつだまさやす	松田雅泰	人名
まつだみきお	松田幹雄	人名
まつながだいじろう	松永大次郎	人名
まつひろりゅうじ	松広隆二	人名
まつひろりゅうじ	松廣隆二	人名
まつもとけんたろう	松本健太郎	人名
まつもとしゅうすけ	松本秀介	人名
まつもとたけろう	松本竹朗	人名
まつもとひこさぶろう	松本彦三郎	人名
まつもとひでお	松本英雄	人名
まつもとひろし	松本洋	人名
まつもとまこと	松本誠	人名
まつもともんきち	松本紋吉	人名
まつもとよしゆき	松本佳介	人名
まつもとりょう	松本遼	人名
まつやぶんぞう	松谷文三	人名
まつやまこうざぶろう	松山光三郎	人名
まつやましげるだま	松山秀玉	人名
まなべかずお	真部一男	人名
まのくすのきみず	眞野楠水	人名
まのめいちのすけ	馬目市之助	人名
ままだしげることぶき	儘田重壽	人名
まみやじゅんいち	間宮純一	人名
まるおかたつみ	丸岡辰美	人名
まるたゆうぞう	丸田祐三	人名
まるやつとうじろう	丸谷傳次郎	人名
まるやましちぞう	丸山七蔵	人名
まるやまただひさ	丸山忠久	人名
まるやまふじこい	丸山藤鯉	人名
まるやよりひで	丸谷順英	人名
みうらくにはる	三浦邦治	人名
みうらし	三浦氏	人名
みうらしげさぶろう	三浦重三郎	人名
みうらひろゆき	三浦弘行	人名
みうらやすなお	三浦泰直	人名
みうらゆういち	三浦優一	人名
みうらゆういちろう	三浦雄一郎	人名
みかみいちたろう	三上市太郎	人名
みかみひろし	三上博司	人名
みかわまさひろ	三川将大	人名
みくにたけさく	三國丈作	人名
みさきいわお	三崎巖	人名
みさわたえこ	三澤多恵子	人名
みさわとおる	美澤亨	人名
みすともひろ	三須智弘	人名
みすみさとし	三角聡	人名
みすみのりまさ	三角憲正	人名
みずいたつや	水井龍也	人名
みずぐちてつや	水口哲也	人名
みずたにとらみやつこ	水谷寅造	人名
みずたにはじめ	水谷創	人名
みずのかつらつとう	水野桂傳	人名
みずのりょうさん	水野良三	人名
みずもとべんぞう	水本弁蔵	人名
みずやまてつひこ	水山哲彦	人名
みぞぐちかつらぶん	溝口桂文	人名
みぞぐちぶんじ	溝口文治	人名
みぞてかずお	溝手一雄	人名
みぞろぎみつはる	溝呂木光治	人名
みたとしひろ	三田敏弘	人名
みたにすすむひろ	三谷晋広	人名
みたにたつ	三谷辰	人名
みたにまさのり	三谷正範	人名
みつむらとおる	三村亨	人名
みなみかわぎいち	南川義一	人名
みなみぐちしげかず	南口繁一	人名
みなみたかゆき	南貴之	人名
みなみなおふみ	南尚文	人名
みなみよしかず	南芳一	人名
みのふとしちろう	蓑太七郎	人名
みはやしひでお	御林秀夫	人名
みはらまさお	三原正雄	人名
みぶちぬいどののすけ	三淵縫殿之助	人名
みまかずお	美馬和夫	人名
みやぎさいち	宮城佐市	人名
みやけこういち	三宅浩一	人名
みやけじゅん	三宅潤	人名
みやけたけきち	三宅丈吉	人名
みやさかゆきお	宮坂幸雄	人名
みやざきいちろう	宮崎一郎	人名
みやざきくにお	宮崎国夫	人名
みやざきひでお	宮崎秀雄	人名
みやざきひろぶみ	宮崎博文	人名
みやざわたくみ	宮沢巧	人名
みやしたかずや	宮下和也	人名
みやしたもりし	宮下森資	人名
みやじはやと	宮地隼人	人名
みやじましげと	宮嶋茂人	人名
みやじまぜんべえ	宮島善兵衛	人名
みやたあきら	宮田暁	人名
みやたあつし	宮田敦史	人名
みやたけなおふみ	宮武尚文	人名
みやたすみはる	宮田純治	人名
みやたてつじ	宮田てつじ	人名
みやたとしお	宮田利男	人名
みやたともかず	宮田友和	人名
みやたひろのり	宮田博徳	人名
みやたみのすけ	宮田巳之助	人名
みやづたかし	宮津隆史	人名
みやづひろふみ	宮津博史	人名
みやのまさひこ	宮野政彦	人名
みやのまなぶ	宮野学	人名
みやはらやすいち	宮原康一	人名
みやはらようすけ	宮原洋介	人名
みやまつせきさぶろう	宮松関三郎	人名
みやもとこうじ	宮本浩二	人名
みやもとしげる	宮本茂	人名
みやもとしるしさ	宮本印佐	人名
みやもとじゅん	宮本淳	人名
みやもととうぞう	宮本藤蔵	人名
みやもとひでき	宮本英樹	人名
みやもとひろし	宮本広志	人名
みよしこうじ	三好晃司	人名
みよしさきょうふとし	三好左京太	人名
みよしつるやま	三好鶴山	人名
むかいるか	迎流歌	人名
むしゃのかつみ	武者野勝巳	人名
むねうちいわお	宗内巌	人名
むらいたつひこ	村井達彦	人名
むらいよしお	村井義夫	人名
むらおしようごろう	村尾正五郎	人名
むらかみえいきち	村上栄吉	人名
むらかみかつらやま	村上桂山	人名
むらかみこうぞう	村上幸三	人名
むらかみしんいち	村上真一	人名
むらかみせいいち	村上誠一	人名
むらかみひとし	村上均	人名
むらかみよしのすけ	村上由之助	人名
むらこしこういち	村越孝一	人名
むらこしためよし	村越為吉	人名
むらたあきひろ	村田顕弘	人名
むらたちほ	村田智穂	人名
むらたともひろ	村田智弘	人名
むらたのぼりかめお	村田登亀雄	人名
むらなかしゅうじ	村中秀史	人名
むらまつきみお	村松公夫	人名
むらまつひさしいち	村松央一	人名
むらまつやすお	村松康雄	人名
むらまつやすゆき	村松泰之	人名
むらやまいさお	村山功	人名
むらやまさとし	村山聖	人名
むらやまたろう	村山太郎	人名
むらやまやすあき	村山慈明	人名
むらやまゆきこ	村山幸子	人名
むろおかかつひこ	室岡克彦	人名
むろたいお	室田伊緒	人名
むろたにさき	室谷早紀	人名
むろやゆき	室谷由紀	人名
めいそんりつま	名村立摩	人名
めぐろすすむ	目黒将	人名
めしよろずしまたきみず	飯萬島瀧水	人名
もうえはやと	馬上勇人	人名
もうりよしゆき	毛利剛之	人名
もくじこうじ	目次康二	人名
もとかわたくさ	本川卓佐	人名
もとたけひと	許武仁	人名
もとやまやすいち	元山康一	人名
もばらまさゆき	茂原正幸	人名
もりうじ	森氏	人名
もりうちとしゆき	森内俊之	人名
もりおかたかし	森岡巍	人名
もりおかまさゆき	森岡正幸	人名
もりけいに	森けい二	人名
もりしたたく	森下卓	人名
もりしたゆうや	森下裕也	人名
もりしんご	盛新吾	人名
もりせき	杜碩	人名
もりたともあき	森田智明	人名
もりたはじめ	森田甫	人名
もりたひろとし	森田宏敏	人名
もりたふゆう	森田富裕	人名
もりたまさみつ	森田正光	人名
もりたむねたつ	森田宗立	人名
もりたやさぶろう	森田弥三郎	人名
もりとしひろ	森敏宏	人名
もりながりゅう	森永龍	人名
もりのぶお	森信雄	人名
もりべなゆた	森部那由多	人名
もりまさゆき	森雅幸	人名
もりまつえいわ	森松英和	人名
もりむらけんぺい	森村賢平	人名
もりもとたいすけ	森本泰介	人名
もりもとひろし	森本弘	人名
もりやすたえこ	森安多恵子	人名
もりやすひでみつ	森安秀光	人名
もりやすまさゆき	森安正幸	人名
もりやまはる	守谷真悠	人名
もりやゆき	守谷友紀	人名
もりよしのり	森美憲	人名
もりわきたろう	森脇太郎	人名
もんじゅ	文殊	人名
もんでんたけひろ	門田健宏	人名
やうちりえこ	矢内理絵子	人名
やぎうらまさあき	柳浦正明	人名
やぐらのりひろ	矢倉規広	人名
やさき	矢崎	人名
やしきのぶゆき	屋敷伸之	人名
やじまごこう	矢島五香	人名
やじましんたろう	矢島新太郎	人名
やすいたかとし	安井貴敏	人名
やすえてるたか	安恵照剛	人名
やすだきよしはちろう	安田清八郎	人名
やすだのりお	安田典生	人名
やすながじろう	安永次郎	人名
やつぎひろゆき	谷次博之	人名
やなぎさわやすとし	柳沢保恵	人名
やなぎはらちょうきち	柳原長吉	人名
やのいつお	矢野逸郎	人名
やのかんじ	矢野勘治	人名
やはしおさむ	矢橋修	人名
やぶつかたけし	薮塚武史	人名
やまうちかずひさ	山内和久	人名
やまうちかずま	山内一馬	人名
やまうちくじゅうろう	山内九十郎	人名
やまうちさちけい	山内祥敬	人名
やまうちしょうたろう	山内庄太郎	人名
やまうちとくりゅう	山内得立	人名
やまうちひろし	山内啓史	人名
やまおかたろう	山岡太郎	人名
やまかたやかろく	山形屋歌六	人名
やまかわあつし	山川敦	人名
やまかわけんぎょう	山川検校	人名
やまかわしもふさまもる	山川下総守	人名
やまかわつぎひこ	山川次彦	人名
やまかわはじめ	山川一歩	人名
やまかわやすしひろし	山川泰煕	人名
やまかわやすしひろむ	山川泰熙	人名
やまがたよしお	山形義雄	人名
やまきたまごさぶろう	山北孫三郎	人名
やまぎしりょうへい	山岸亮平	人名
やまぐちいさむ	山口勇	人名
やまぐちえみな	山口絵美菜	人名
やまぐちえりこ	山口恵利子	人名
やまぐちえりこ	山口恵梨子	人名
やまぐちかずと	山口和人	人名
やまぐちこうき	山口孝貴	人名
やまぐちしんこ	山口真子	人名
やまぐちちみね	山口千嶺	人名
やまぐちなおや	山口直哉	人名
やまぐちひでお	山口英夫	人名
やまぐちひでかず	山口秀一	人名
やまぐちひとみ	山口瞳	人名
やまぐちひろし	山口大志	人名
やまぐちひろし	山口浩	人名
やまさきたかゆき	山崎隆之	人名
やまさきたかゆき	山ｱ隆之	人名
やまざきあきらさん	山崎璋三	人名
やまざきけんた	山崎健太	人名
やまざきこうとう	山崎勾当	人名
やまざきしげき	山崎茂樹	人名
やまざきまさあき	山崎将明	人名
やまざきやすお	山崎康雄	人名
やまざきようすけ	山崎陽介	人名
やまざきよしたろう	山崎由太郎	人名
やましたかずこ	山下カズ子	人名
やましたかつとし	山下勝利	人名
やましたぎいち	山下義一	人名
やましたさく	山下サク	人名
やましたさち	山下祥	人名
やましたさやか	山下紗矢佳	人名
やましたたかし	山下隆司	人名
やましたつよし	山下雄	人名
やましたはんじ	山下半次	人名
やまたにあや	山谷綾	人名
やまだあけみ	山田朱未	人名
やまだあつもと	山田敦幹	人名
やまだかずこ	山田和子	人名
やまだかなが	山田賀永	人名
やまだくにひろ	山田邦博	人名
やまだくみ	山田久美	人名
やまだこうじ	山田幸二	人名
やまださちご	山田祥五	人名
やまだしんぢ	山田慎治	人名
やまだせいじ	山田政司	人名
やまだたいへい	山田泰平	人名
やまだなおひろ	山田尚宏	人名
やまだみちよし	山田道美	人名
やまだやすはる	山田靖治	人名
やまだやすひら	山田康平	人名
やまだやすひろ	山田康弘	人名
やまだゆうすけ	山田雄介	人名
やまだようじ	山田洋次	人名
やまだりきのすけ	山田力之助	人名
やまでらきよし	山寺清志	人名
やまなかうらいち	山中浦一	人名
やまなかかずまさ	山中和正	人名
やまなかけいすけ	山中恵介	人名
やまなかゆうき	山中裕樹	人名
やまねことみ	山根ことみ	人名
やまのつよし	山野剛	人名
やまむらまさお	山村正夫	人名
やまもといっせい	山本一成	人名
やまもとかおる	山本薫	人名
やまもとくすのきろう	山本樟郎	人名
やまもとけいいち	山本圭一	人名
やまもとさと	山本郷	人名
やまもとしげき	山本茂樹	人名
やまもとしげるじゅ	山本繁樹	人名
やまもとしんいち	山本信一	人名
やまもとしんいちろう	山本伸一郎	人名
やまもとしんや	山本真也	人名
やまもとたかひろ	山本崇弘	人名
やまもとたけお	山本武雄	人名
やまもとてるお	山本照夫	人名
やまもととういつ	山本統一	人名
やまもととうじろう	山本藤次郎	人名
やまもとひろし	山本博志	人名
やまもとまこと	山本慎	人名
やまもとまさと	山本真人	人名
やまもとりゅうきち	山元隆吉	人名
ゆうこますかたろう	遊駒スカ太郎	人名
ゆかわけいこ	湯川恵子	人名
ゆがわかつみ	湯川克己	人名
ゆじゅんすぐる	湯順傑	人名
ゆたかたよしわたる	豊田宣弥	人名
ゆのえしんじ	湯上真司	人名
ゆみねかずゆき	湯峯一之	人名
よいつ	与都	人名
よこいたけうえもん	横井丈右衛門	人名
よこいひさよし	横井久義	人名
よこざわおさむ	横沢修	人名
よこたたかひろ	横田高広	人名
よこやまきんもち	横山公望	人名
よこやまだいき	横山大樹	人名
よこやまひろあき	横山泰明	人名
よこやまゆきお	横山幸男	人名
よしいあきら	芳井晶	人名
よしいおおう	吉井大生	人名
よしおかだいわ	吉岡大和	人名
よしかわともき	吉川朋樹	人名
よしかわとよぞう	吉川豊蔵	人名
よしざわだいき	吉澤大樹	人名
よしざわでんしろう	吉沢伝四郎	人名
よしたいちたすく	吉田市輔	人名
よしだきよしひょうえ	吉田清兵衛	人名
よしだこういち	吉田幸市	人名
よしださくぞう	吉田作蔵	人名
よしだしょうた	吉田翔太	人名
よしだたくみ	吉田拓未	人名
よしだたさぶろう	吉田多三郎	人名
よしだとしかつ	吉田利勝	人名
よしだとしや	吉田俊哉	人名
よしだともみつ	吉田朝光	人名
よしだなおみ	吉田直躬	人名
よしだはじめ	吉田一歩	人名
よしだひろし	吉田浩	人名
よしだまさかず	吉田正和	人名
よしだゆきお	吉田幸夫	人名
よしだゆみ	吉田優美	人名
よしだよしお	吉田義男	人名
よしだよしお	吉田義雄	人名
よしだりょうへい	吉田陵平	人名
よしだろくひこ	吉田六彦	人名
よしづみきよし	吉積喜由	人名
よしながさゆり	吉永小百合	人名
よしながみのる	吉永稔	人名
よしのきんぞう	吉野金蔵	人名
よしのまり	吉野真理	人名
よしまつゆきお	吉松幸雄	人名
よしみまさひろ	吉見政宏	人名
よしみもとき	吉見元希	人名
よしむらけいいち	吉村慶一	人名
よしむらまさゆき	吉村正幸	人名
よしもとゆうた	吉本悠太	人名
よだゆうじ	依田有司	人名
よつやふじうえもん	四ツ谷藤右衛門	人名
よねたにひでひこ	米谷秀彦	人名
よねだとおる	米田徹	人名
よねながくにお	米長邦雄	人名
よねむらりへえ	米村利兵衛	人名
よねやまだいすけ	米山大介	人名
よんだいいとうとくひさし	四代伊藤得寿	人名
よんだいおおはしたかしあずか	四代大橋宗与	人名
りさほ	梨沙帆	人名
りゅうおうせんくらぶめんばー	竜王戦倶楽部メンバー	人名
りんかいほう	林海峰	人名
れんごうぐん	連合軍	人名
ろくだいいとうたかしみ	六代伊藤宗看	人名
ろくだいおおはしそうえい	六代大橋宗英	人名
ろくだいおおはしたかしぎん	六代大橋宗銀	人名
ろじゅひ	露樹陽	人名
わいだゆうじ	和井田祐司	人名
わかいこうざぶろう	若井幸三郎	人名
わかしまただし	若島正	人名
わかばやしたけし	若林猛	人名
わかばやしひさお	若林久雄	人名
わかばやしまさとし	若林正俊	人名
わかふじあき	若藤亜季	人名
わかまつまさかず	若松政和	人名
わきけんじ	脇謙二	人名
わきさかげんえもん	脇坂源右衛門	人名
わたせそうじろう	渡瀬荘次郎	人名
わたづすみお	渡津澄夫	人名
わたなべあいせい	渡辺愛生	人名
わたなべあきら	渡辺明	人名
わたなべかずし	渡辺和史	人名
わたなべきょうい	渡辺恭位	人名
わたなべけいろう	渡辺慶朗	人名
わたなべけんじ	渡辺憲司	人名
わたなべけんや	渡辺健弥	人名
わたなべさぶろう	渡辺三郎	人名
わたなべじゅん	渡辺純	人名
わたなべそうだい	渡部壮大	人名
わたなべたけしし	渡辺剛史	人名
わたなべとういち	渡辺東一	人名
わたなべとしお	渡辺俊雄	人名
わたなべのりゆき	渡辺徳之	人名
わたなべひさのり	渡辺久記	人名
わたなべひろむ	渡辺大夢	人名
わたなべまこと	渡辺誠	人名
わたなべまな	渡部愛	人名
わたなべみつのぶ	渡部光宣	人名
わたなべやよい	渡辺弥生	人名
わたなべゆんふと	渡辺ゆん太	人名
わたなべりだか	渡辺利高	人名
わたなべりゅういち	渡部隆一	人名
わたなべりょう	渡辺諒	人名
わだあき	和田あき	人名
わだしょうべえ	和田庄兵衛	人名
わだしるしあきら	和田印哲	人名
わだしんじ	和田真治	人名
わだしんや	和田信也	人名
わだすみと	和田澄人	人名
わだそうきち	和田宗吉	人名
わだなおざぶろう	和田直三郎	人名
わだなおた	和田柔大	人名
わだまごへいまもる	和田孫兵衛	人名
わだみなみえだ	和田南枝	人名
わだりょうおう	和田竜王	人名
わにぶちひろし	鰐淵啓史	人名
あいかわはるか	相川春香	人名
かにがこい	カニ囲い	名刺
きんやぐら	金矢倉	名刺
ぎんやぐら	銀矢倉	名刺
かたやぐら	片矢倉	名刺
そうやぐら	総矢倉	名刺
やくらあなぐま	矢倉穴熊	名刺
きくすいやぐら	菊水矢倉	名刺
ぎんたちやぐら	銀立ち矢倉	名刺
ひしやくら	菱矢倉	名刺
がんぎがこい	雁木囲い	名刺
ぼなんざかこい	ボナンザ囲い	名刺
みのがこい	美濃囲い	名刺
たかみのがこい	高美濃囲い	名刺
ぎんかんむり	銀冠	名刺
ぎんみの	銀美濃	名刺
だいやもんどみの	ダイヤモンド美濃	名刺
きむらみの	木村美濃	名刺
かたみのがこい	片美濃囲い	名刺
ちょんまげみの	ちょんまげ美濃	名刺
ぼうずみの	坊主美濃	名刺
ひだりみの	左美濃	名刺
てんしゅかくみの	天守閣美濃	名刺
よんまいみの	四枚美濃	名刺
はしぎょくぎんかん	端玉銀冠	名刺
くしかつがこい	串カツ囲い	名刺
ふなかこい	舟囲い	名刺
いびしゃあなぐま	居飛車穴熊	名刺
まつおりゅうあなぐま	松尾流穴熊	名刺
ぎんかんあなぐま	銀冠穴熊	名刺
びっぐふぉー	ビッグ４	名刺
はこいりむすめ	箱入り娘	名刺
みれにあむがこい	ミレニアム囲い	名刺
ふりびしゃあなぐま	振り飛車穴熊	名刺
みぎやぐら	右矢倉	名刺
きんむそう	金無双	名刺
なかずまい	中住まい	名刺
なかはらぎょく	中原玉	名刺
あひるがこい	アヒル囲い	名刺
いちごがこい	いちご囲い	名刺
さんななぎんせんぽう	３七銀戦法	名刺
わきしすてむ	脇システム	名刺
やぐらぼうぎん	矢倉棒銀	名刺
もりしたしすてむ	森下システム	名刺
すずめざし	雀刺し	名刺
よねながりゅうきゅうせんやぐら	米長流急戦矢倉	名刺
かにかにぎん	カニカニ銀	名刺
なかはらりゅうきゅうせんやぐら	中原流急戦矢倉	名刺
あくつりゅうきゅうせんやぐら	阿久津流急戦矢倉	名刺
やぐらなかびしゃ	矢倉中飛車	名刺
みぎしけんびしゃ	右四間飛車	名刺
げんしぼうぎん	原始棒銀	名刺
みぎぎょく	右玉	名刺
かまいたちせんぽう	かまいたち戦法	名刺
ぱっくまんせんぽう	パックマン戦法	名刺
しんよねながぎょく	新米長玉	名刺
いなにわせんぽう	稲庭戦法	名刺
よんてかく	四手角	名刺
かくがわり	角換わり	名刺
かくがわりこしかけぎん	角換わり腰掛け銀	名刺
かくがわりはやくりぎん	角換わり早繰り銀	名刺
すじちがいかく	筋違い角	名刺
きむらじょうせき	木村定跡	名刺
いってぞんかくがわり	一手損角換わり	名刺
あいかかり	相掛かり	名刺
あいかかりぼうぎん	相掛かり棒銀	名刺
つかだすぺしゃる	塚田スペシャル	名刺
なかはらりゅうあいがかり	中原流相掛かり	名刺
なかはらひしゃ	中原飛車	名刺
こしかけぎん	腰掛け銀	名刺
くさりがまぎん	鎖鎌銀	名刺
はちごうひしゃせんぽう	８五飛車戦法	名刺
よこふどり	横歩取り	名刺
さんさんかくがたくうちゅうせんぽう	△３三角型空中戦法	名刺
さんさんけいせんぽう	△３三桂戦法	名刺
よんごうかくせんぽう	△４五角戦法	名刺
あいよこふどり	相横歩取り	名刺
ごきげんなかびしゃ	ゴキゲン中飛車	名刺
つのぎんなかびしゃ	ツノ銀中飛車	名刺
ひらめ	平目	名刺
かざぐるま	風車	名刺
しんかざぐるま	新風車	名刺
えいちゃんりゅうなかびしゃ	英ちゃん流中飛車	名刺
げんしなかびしゃ	原始中飛車	名刺
かとうりゅうそでびしゃ	加藤流袖飛車	名刺
ごうななきんせんぽう	５七金戦法	名刺
ちょうきゅうせん	超急戦	名刺
しけんびしゃ	四間飛車	名刺
ふじいしすてむ	藤井システム	名刺
たていしりゅう	立石流	名刺
れぐすぺ	レグスペ	名刺
さんけんびしゃ	三間飛車	名刺
さんげんびしゃ	三間飛車	名刺
いしだりゅう	石田流	名刺
はやいしだ	早石田	名刺
ますだしきいしだりゅう	升田式石田流	名刺
おにごろし	鬼殺し	名刺
さんにーひしゃせんぽう	△３ニ飛戦法	名刺
さんにひしゃせんぽう	△３ニ飛戦法	名刺
さんにいひしゃせんぽう	△３ニ飛戦法	名刺
なかたいさおえっくすぴー	中田功ＸＰ	名刺
まなべりゅう	真部流	名刺
ななはちひせんぽう	▲７八飛戦法	名刺
よんさんせんぽう	４→３戦法	名刺
くすもとしきいしだりゅう	楠本式石田流	名刺
しんいしだりゅう	新石田流	名刺
しんおにごろし	新鬼殺し	名刺
だいれくとむかいびしゃ	ダイレクト向かい飛車	名刺
むかいびしゃ	向飛車	名刺
めりけんむかいひしゃ	メリケン向かい飛車	名刺
さかたりゅうむかいびしゃ	阪田流向飛車	名刺
かくとうふせんぽう	角頭歩戦法	名刺
おにごろしむかいびしゃ	鬼殺し向かい飛車	名刺
ようどうふりびしゃ	陽動振り飛車	名刺
つくつくぼうしせんぽう	つくつくぼうし戦法	名刺
あいふりびしゃ	相振り飛車	名刺
ぽんぽんけい	ポンポン桂	名刺
ごすじくらいどり	５筋位取り	名刺
ぎょくとうくらいどり	玉頭位取り	名刺
ちかてつびしゃ	地下鉄飛車	名刺
いいじまりゅうひきかくせんぽう	飯島流引き角戦法	名刺
まるやまわくちん	丸山ワクチン	名刺
よんろくぎんひだりきゅうせん	４六銀左急戦	名刺
よんごうほはやじかけ	４五歩早仕掛け	名刺
よんごほはやじかけ	４五歩早仕掛け	名刺
よんごーほはやじかけ	４五歩早仕掛け	名刺
さぎのみやじょうせき	鷺宮定跡	名刺
よんろくぎんみぎきゅうせん	４六銀右急戦	名刺
ひだりみのきゅうせん	左美濃急戦	名刺
みぎしけんびしゃきゅうせん	右四間飛車急戦	名刺
とりざし	鳥刺し	名刺
うれしのりゅう	嬉野流	名刺
ぼうぎん	棒金	名刺
ちょうそく	超速	名刺
